//词语， 不要在第一行增加内容，留给注释用
GNU/Linux	GNU/Linux
前往	前往
图形	D型的
图形用户界面	D形使用者介面
图形	D形
图形设备接口	D形b置介面
灰阶	灰A
灰名单	灰名
格子	牛桓褡
组ID号	群MRea
	旁]群集
处理	置
硬盘	硬碟
硬件	硬w
	C{m
	C{使用者w
头文件	祟^n案
高	高度
帮助	f明;求助(息)
帮助文件	f明n案
预定到期时间	AO到期rg
隐藏	[藏
高级	高
高阶	高A
高亮	高亮度;反白;凸@(耸)
提示	提示
历史	v史
个人文件夹	人Y料A;首
个人文件夹起始目录	家目；起始附
首页	首
	水平
主	主C
主语言	主CZ言 
主机	主C
主页	主W、主
主机名	主C名
HTML 超文本标记语言	超文件耸菊Z言
HTTP 超文本传输协议	超文件魉f定
混合文档	混合文件
超链接	超接
超文本	超本文
图标	D示
等同	等同
已识别数据	已ReY料
标识符	Re符
表义字符	表意文字
继承	^承
图片	影像
图片数据	影像Y料
图片地图	影像地D
执行	作
执行符合性声明	作符合性明
执行平台	作平_
隐性规范	[性法t
隐性WEB请求	[式W路求
导入	R入
导入关闭	R入]包 
非活动页	非使用中面
流入	流入
收件箱	收件匣;信箱
包含文件	包含n
包含的	包含的
不一致	不一致的
缩进	s排
独立软件供应商	立w供商
独立WEB	立W
索引	索引；指
	索引循序存取法
索引色	索引色
索引的	索引的
间接包含	g接包含
独立	w
独立值属性	wr值性|
推理	推理
通知	通知
信息空间	Y空g
信息	Y (理中)
参考文本	⒖急疚
行内	行
输入配置	入MB
输入项目	入目
输入(数据)	入(Y料)
输入(程序)	入(程序)
查询	查
插入	插入
插入列	插入
插入文件	插入n案
插入行	插入列
安装	安b
实例	例
实例数据	例Y料
实例数据节点	例Y料c
举例	e例
整数	整
集成电路	ew路
完整性	完整性
	智慧a
增强	增
交互	互;交互作用
交互式	交式
交互式用户	互邮褂谜
界面；接口	介面
接口定义语言	介面定xZ言 (IDL)
中间文件	中gn案
内部的	炔康
内部实体	炔w
内部错误	炔垮e`
国际标准组织	H式M
国际化资源标识符	H化Y源Re符
互联网	WHW路
	WHW路控制息f定
网路电话	W路
网络协议	WHW路f定
网络聊天	W路聊天
网络服务提供商	WHW路服仗峁┱
可交互性	交互\作性
解释语言	直g式Z言
解释	直g
解释程序环境	直g器Z境
局域网	炔烤W路
固有维度	固有S度
无效的	o效
反函数	反函
不可见	不可
议题；	l出;h}
项目	目
Java语言规范	JavaZ言
Java虚拟机	JavaMC器
	曲下d
JPEG图片格式	JPEGD形格式
	uU
垃圾邮件	垃圾信(件)
核心	核心
钥匙；键	金;I
	金MY
键入	I入
键定位	金定位
钥匙管理	金管理
键名	金名Q
中止	中止
抽象类	抽象e
抽象声明符	抽象宣告符
抽象文件	摘要n案
	存取遮罩
	ACE 存取控制 
帐户	ぬ
累加器	累加器
获得	@取
激活	活化子
活动，现用	作用的；活拥
适配器	介面卡；{m器
加法运算符	加法\算子
取址方式	定址模式
取址运算符	取址\算子
	相簿；］
算法	演算法
别名	e名
欠真	混淆；X；取邮д
对齐	R
允许	允S；容S
歧义表达式	歧x\算式
分析器	分析器
角	角
应答	答
立即应答	立即答
应答超时	答逾r
消除锯齿；抗锯齿	消除X
反对数	反
应用	套用
弧度	弧度
档案位置	n案位置
归档	嚎sn案；存n；wn
算术移位	算g移位
排列	排列
数组	列
人工智能	人工智慧
艺术家	演出者名Q
递增	f增
	外^
汇编语言	M合Z言
关联；协会	Y合；P；f
结合性	Y合性
附件	附件
音频光盘	音光碟
音频压缩	音嚎s器
音频流	音串
视听交叉格式	AVI影音格式
辅助文件	o助n案
平均数据率	平均Y料流量
平均值	平均值
	背r窗
背景样式	背景邮
反向引用	反向引用
平衡	平衡
道带；频带；[地]带 	В活l
带宽	l
横幅	M幅
条码	la
密件抄送	密件副本
节拍	拍
行为	行
最好；最佳	最好；最佳
斜角	斜面；斜角
	斜入
	斜出
贝塞尔点	控制c
立方体	p立w
双向	p向
双线性过滤	p性^V
双语	pZ
二分搜索	二元搜
二叉数	二元
邦定	MY
邦定内容	MY热
位字段	位元谖
位图	cD
按位	逐位元
按位运算	位元\算子
混合呈图	混合映像
混合	混合
呈图方向	映像方向
块符号	K罘K
阻止的横幅	阻嗟M幅
阻止的弹出式窗口	阻嗟出式窗
阻止操作	阻嘧I
块	KD案
模糊	模糊
[主]体	主文；本w
样板	影澹齑娲a
布尔	布林
可引导光盘	可_C光碟
自展程序	虞d入器
边框	框
上边框	上框
下边框	下框
边框颜色	框色彩
	框圈x
边框样式	框邮
边框框宽度	框度
底边界	底界
[受]束缚；界	界限
界限列	界限
	盒钍湛s
	盒罘派
括号匹配	括ΨQ
带括号的表达式	有括的\算式
打散	打散
增亮	增亮
广播地址	V播位址
中断的连接	中嗟倪BY
桥路由器	蚪勇酚善
浏览按钮组	g[按oM
浏览外观	g[外^
浏览字体	g[字型
[画]笔	P刷
笔头	P刷^
协同控制	f同控制
缓冲；缓冲器；缓冲器[区]	n器；n；n^
缓冲区欠载运行	n^欠d\行
整体；大量	大量
大量复制程序	大量}u程式
大量记录字段交换	大量Y料谖唤Q
多行存取	大量Y料列X取
刻(烧)录	
刻(烧)录设置	O定值
刻(烧)录程序	程序
刻(烧)校验	保C
总线	R流排
商业逻辑层	I者
商业物件	I瘴锛
商业流程	I樟鞒
商业规则	I找t
按钮阴影	按o暗影
按钮表面	按o表面
按钮反白	按o反白
按钮淡影	按o淡影
	略^清
C调用惯例	C 呼叫T例
C联系规范	C BM
	封包０腹c
	封包n案a生器
校准	校
调用；呼叫	呼叫
调用树	呼叫
回调	回呼
回调字段	回呼谖
回调函数	回呼函式
呼叫惯例	呼叫T例
摄影机	z影C
取消	取消
候选函数	候x函式
候选键	候xI
	效能z器
倒 v 号	插入
回车	回I
回车换行	CRLF 臀Q行M
卡通	卡通
级联	串；重B窗；重B@示
案例	案例
卡式磁带	卡
转换	D型
分类	分
因果ID	因果 ID
抄送	副本
逆时针	逆r
CD音频属性	CD 音特性；CD 音热
复制光盘	}u光碟
居中对齐	置中R
对齐表单中央	R表沃醒
居中对齐	置中R
链	；接
变更；改变	更
频道定义格式	CDF l道定x格式
字符	字元
图[表]	D表
检查	勾x；z查；核取
签入	入
签出	出
检验（查）和	和z查a
芯片	晶片
凹刻	凹刻
凸刻	凸刻
选择	x取
套索	套索
	^K包b函式
圆形收缩	A形收s
圆形放射	A形放射
循环依赖	循h相依
循环引用	循h⒖
	e衍化清
类ID	eRe
清除	清除
裸机	初始B的X
点(单)击	按
剪裁文件	素材n案
剪裁路径	裁剪路
时钟	r
顺时针	r
克隆	仿u；仿u品
聚类；簇；群集[器]	布
代码转换器	解a器
类型强制转换	制型D
	s回上
理序	理序；自臃猪
理序	定序；校
组合	合
命令	命令
命令集	命令集
注释定界符	]解定界符
移除注释	移除]
委任	委任
通用控制	通用控制
公共数据记录	通用Y料
通用对话框	通用υ方K
通用目标文件格式	COFF 通用物件n案格式
比较	比^元
比较	比^
比较器	比ψ樱槐容^器
编译器缺陷报告	g器缺失蟾
编译期错误	gr期e`
补	互a；a色
完整目标	完整物件
复杂指令集计算机	CISC }s命令集X 
复杂脚本	}s_本
复杂邦定	}sMY
构件对象模型	COM 元件物件模型
组成	撰
复合文档	}合文件
计算机辅助翻译	Xo助翻g
拼接键	串B索引I
拼接操作	串B\算子
具体	具w
并发性	K行
并发连接	同rB
条件表达式	l件\算式
确认	_J
冲突	n突
连接断开	B切
连接中	使用中B
连接中断	B中
固定比特率	固定位元率
约束比例	制等比例
构造	建式；建函式
接触	洽
包含	包含
反差，对比度	Ρ龋Ρ榷
版权	版
计数	
覆盖	封套
	爆音
当机	C
开发小组	_l小M
临界区（段）	PI^段；R界^段
剪除	剪裁
交叉编辑	交互
淡入淡出	交e淡
十字指针	十字游
交叉制表查询	交叉Y料表查
跨线程	跨程
密码术	加密
插进指令表	提示表
货币	
曲线	曲
	重覆循h
循环冗余校验	循h冗Nz查
仪表盘	x表板
数据访问对象	DAO Y料存取物件
数据断点	Y料中帱c
数据率	Y料速率；Y料鬏率
数据邦定	Y料MY
数据报	Y料包
数据报套接字	Y料包通端
数据工作表	Y料工作表
分贝	分
死[代]码	o作用程式a
调试，排错	除e
译（解）码器	解a器
装饰名	b名Q
减量；减去	fp
纵深副本	深友}u
延期	延t的
变形	形
	去交e
等待指针	延t游
	延t演算上色
延时传送	魉脱俞
延时载入	延td入
委派	委派
全部删除	全部h除
删除行	h除行
删除至行尾	h至行尾
删除至行首	h至行首
定界符	定界符
三角方向	三角方向
部署	部署
间接引用	解⒖
导出类[别]	子e；衍生e
导出类型	衍生型式
降序	fp；fp排序
描述	描述
取消所选	不x；取消x取
	原序列化
设计	O
指定符	指定符
设计者	O者
设计者主程序	O者主程式
设计期控制	DTC Or期控制
设计期对象	Or期物件
设计期的	H限Or期
桌面	桌上型；桌面
销毁	N
分开	拆x
细节	
检测	y
开发者	_l者
开发环境	_lh境
程序开发服务器	程式_l伺服器
设备控制块	DCB 控制^KY料
设备驱动程序	b置映淌
诊断服务	\喾
拨号	芴
按需拨号	S需芴
对话框列	υ方K列
对话数据交换	DDX υY料交Q
对话数据校验	DDV υY料C
对话单元	DLU υ方K挝
拨号网络适配器	芴W路配接卡
拨号网络连接	芴W路B
拨号服务器	芴伺服器
差异查看器	差z器
扩散	U散
数字化日期	滴换日期
数字视频	滴灰
数字化	滴换
数字	底
有向图  	合w字；有向D
维；维度；尺度；尺寸	S；S度；尺度；尺寸
灰暗(无效)文字	o效文字
直接电缆连接	直接|B
直接连接	直接B接
方向	方向
目录清单对话框	目清畏K
反汇编	反Mg器
光盘刻录一次	DAO 光碟一次 
免责声明	免明
断开连接	中
断续图形	嗬mD形
光盘卷标	磁碟嘶`
分派	分派
弥散的	分散式
分配界面	分配介面
处理；处置	置
溶解	溶解
失真，畸变	扭曲；失真
分布；分配	分配；分散
发行版	l行版
分布式应用程序	分散式用程式
分布式构件对象模型	DCOM 分散式元件物件模型
分布式计算环境	DCE 分散式\算h境 
分布式管理环境	分散式管理h境
分布式处理器	DTU 分散式交易f{器
发抖	f色
分割线样式	分割邮
//除	^K；部T
入坞	停v
文档传阅精灵	文件鏖精`
文档模板	文件模板
加亮	加亮
域名后缀	W域字尾
主控	主控制
点颜色	Ac色彩
点运算	句c\算子
点形状	c
点大小	Ac大小
点距	c距；Acg距
点变量	Ac量
双击	快按纱
双倍大小	杀洞笮
两倍行距	杀缎虚g距
双字节字符集	DBCS p位元M字元集
双精度	倍精度
双面水平打印	p面水平列印
双面垂直打印	p面垂直列印
向下键	向下I
按下状态	按下B
降低密级  	降
下载	下d
下降混合	下降混合
降低取样	降低取
下游	下游
	不透明理
驱动	
驱动器；驱动程序	映淌
驱动程序开发包	DDK 映淌介_l套件 
驱动器磁盘	映淌酱牌
驱动器名	磁碟C代
驱动程序模块	映淌侥＝M
滴落深度	滴落深度
下拉	下拉
水滴半径	水滴半
滴落阴影	滴落影
置放来源	置放碓
置放目标	置放目
下拉式组合框	下拉式M合方K
遗漏框	z漏框
滴管	滴管
双重界面	p重介面
双通道	pl道 (pZ)
哑，虚设	O
转储  	A印
转储电影	出影
持续时间	持mrg；vr
DVD；数字[多功能]光盘	DVD 多功能滴坏片
动态邦定	BMY
动态数据交换	BY料交Q 
动态超文本标记语言	B超文字擞Z言
动态连接	BBY
动态连接库	DLL BBY程式
易用	易操作
易移除	易移模式
易更新	易用更新
椭圆	EA
边缘	
可编辑性	可性
编辑器	器
编辑风格	撰L格
效果	效果
效果类型	效果N
有效抵制	有效位址
弹出	退出；出
经历时间	^rg
升降移动	升降移
升降感应器	升降感器
椭圆工具	EA形工具
省略	省略
强调	{
仿真	模M
	封]；外ぃ桓郊
编码	a
环绕类型	@型式
加密	加密
加密触发器	加密|l器
结束	端；Y束
结束端点	Y束端c
文件结束	n案Y尾
结束时间	rgKc；Y束rg
结束轨	Y束
最终用户	K端使用者
最终用户许可协议	EULA 使用者授嗪霞s
工程师	工程；工程
增强型元文件	增型中^n案
放大	放大
排队	M入辛
企业版	企I版
入口	入口；；目；登
列举	列e
枚举属性	列e性|
枚举类型	列e型式
包；封	分封；封套
环境	h境
结束码	Y尾a
等运算	等式\算子
等化器	等化器
等连接	等Y
擦除	抹除
橡皮擦工具	橡皮擦工具
错误执行	e`绦
错误检查	e`z查
纠错	e`更正；`差校正
错误处理器	e`理常式
错误信息	e`息
错误代码	e`代
转义字符	逸出字元
事件产生	事件冒出
事件处理器	事件理常式
事件接口	事件介面
事件侦听器	事件收器
事件日志	事件日I
事件映射	事件τ
	事件遮罩
事件对象	事件物件
事件程序	事件程序
事件登记	事件登
事件应答对象	事件回物件
事件计划	事件方案
事件脚本程序	事件_本程序
事件接受	事件接收
事件接受映射	事件接收τ
事件接收	事件接收
事件来源	事件碓
事件驱动	事件
事件处理程序	事件理程序
事件就绪	事件就w
事件接受	事件接收
每隔行	跳式
每隔像素	跳像素
标志项集	辨R集
举例	例
异常声明	常宣告
异常处置器	常理常式
异常处理展开	常理展_
异常规则	常格
排除	排除
互斥模式	互斥模式
执行字符集	绦凶衷集
免除	豁免
存在	存在
存在	F有
退出并返回	退出KD回
退出帮助	退出求助
扩大；展开	展_；U展
展开分支	展_分支
展开文件夹	展_Y料A
展开圈选	展_圈x
展开一层	展_一
扩充内存	U充w
专家模式	＜夷Ｊ
显式初始化	外@初始O定式
显示接口成员执行	外@介面成T作
显示连接	外@BY
显示参考	外@⒖
资源管理器	n案管
阶	指
公开	公_
表达式求值	\算式u估器
表达式语句	\算述式
扩充	延伸；U充
扩充器	U充器；延伸器
可扩展样式表语言转换	XSLT 可延伸邮奖碚Z言DQ
扩展内存	延伸w
滴管工具	滴管工具
淡变	淡
淡入	淡入
淡出	淡出
淡变速度	淡速度
失败	失。皇效
失效后资源备份	容e移D
快速复制	快速}u
正向快转	正向快D
快速播放	快速播放
反向快转	反向快D
快速扫描	快速呙
快速载入区域	快速d入^域
羽化	羽化
羽化填充	羽化填充
羽化选择	羽化x
特征树	特徵
存入文件	提取
字段定界符	诙界符
字段类型	谖恍褪
文件分配表	FAT n案分派表
文件关联管理	n案P管理
文件缓冲区	n案n^
文件截取	n案X取
文件计数	n案
文件描述	n案描述
文件例外	n案例外
文件处理	n案置
文件增量	n案增量
文件输入/输出	n案出入
文件长度	n案L度
文件列表	n案表列
文件锁定	n案i定
文件指针	n案指
文件性质	n案性|
文件范围	n案
文件状态	n案B
文件系统	n案系y
文件时间	n案rg
文件跟踪器	n案追器
文件数	n案
文件类型	n案型式
文件名	n案名Q
文件扩展名	副n名
文件服务器应用	n案伺服器用
填充	填充
填充颜色	填充色彩
填充因素	填充因子
填充段	填充段
填充样式	填充式
填充类型	填充型式
实心三角形	心三角形
电影	片；影片
电影片断	影片片段
过滤器，筛选程序	V波器
最终化	最K化
最终化光盘	最K化光碟
最终化磁盘	最K化磁碟
文件内查找	n案ふ
在多个文件内查找	多重n案ふ
在项目内查找	０ふ
查找上一个	ふ疑弦
查找符号	ふ曳
查找内容	ふ夷
查找文字	ふ椅淖
细致；精细	@；精
完成	完成
激发	引l
激发事件	引l事件
第一个记录	第一P
符合页面	符合面
修复；固定	修停还潭
定位	定位
固定对话框	固定υ方K
固定调色板	固定色P
固定单一	固定我
固定工具窗口	固定工具窗
定长字符串	定L字串
固定字幅	固定字幅
修复；固定	修
平	平
平面合成图象	平面合成影像
浮动工具条	浮D示工具列
平面化	平面化
平面化层	平面化D
	避免重LW
浮点数[类型]	浮樱桓↑c
浮动	浮
浮动框	浮涌
浮点	浮c
浮动工具条	浮庸ぞ吡
浮点类型	浮cY料型式
浮点函数	浮c函
浮点数值	浮c抵
浮点操作	浮c作I
流控制	流量控制
齐平	清除
焦点	焦c
焦点矩形	焦c矩形
定焦矩形	定焦矩形
文件夹跟踪器	Y料A追器
折叠线	折B
字型文件	字型n
字型映射	字型τ称
字型映射	字型τ
字型资源	字型Y源
字型方案	字型方案
字型视图	字型z
仅限私用	H限私用
强制	制
强制帧大小	制框大小
强制每秒帧数	制每秒框
前景颜色	前景色彩
前景颜色	前景色彩
情景窗口	前景窗
外来应用程序	外用程式
外来图像	外碛跋
外健	外硭饕I
外健表	外硭饕I表
表格类别	表格e
表格设计者	表格O者
表格编辑器	表格器
表格线设定	表格格O定
表格图像	表格影像
表格布局	表格布局
表格布局窗口	表格布局窗
表格类型	表格型式
表格视图	表格z
形式参数	形式引
形式参数列表	形式当砹
格式定义块	格式定xK
格式化磁盘	格式化磁碟
格式化字符串	格式串
格式样式表	格式邮奖
格式器	格式器
格式化…	格式化中
格式化矩形	格式化矩形
格式化工具条	格式化工具列
表格举出应用	表格基A用
表格层次	表格哟
转发	正向，D送
正向声明	前置宣告
向前一帧	向前一框
向前参考	向前⒖
已转发	已D信
仅向前	H正向
基础类	基Ae
四字节码	四字元a
帧/秒	框每秒
逐帧播放	逐框播放
帧控制	框控制
帧抓取	框抓取器
帧页	框
帧速率	框速率
逐帧反转	逐框反D
流帧大小	串流框大小
帧窗口	框窗
帧遗漏	z漏框
帧/秒	框每秒
帧集；框架	框集
框架	框架
步骤框架	步E框架
帧错误	框e`
可用位	可用位元M
可用图形界面资源	可用D形介面Y源
可用图像位	可用影像位元M
可用内存	可用w
可用页面	可用面
可用系统资源	可用系yY源
	o限制程封送理器
无限线程	o限制程
无限线程模型	o限制程模型
自由变换	自由Q
可以用户资源	可用使用者Y源
自由格式模型	自由格式模型
自由格式工具	自由格式工具
样本率频率	颖韭暑l率
常见问题[集]	常}集
	H和名Q
帧	框
帧/秒	框每秒
从	l信人；
前端	前端
全部控件	完全控制M件
	完全 DV 品|
完整连接	完全BY
	全模Mz
完整外部连接	完整外部Y
完整路径	完整路矫Q
全屏模式	全幕模式
全特化	全特化
完整帧	完整面
	完全品|X取
全屏	全幕
全形	全形
完整类名	完整e名Q
功能；函数	功能；函
函数体	函抵黧w
函数调用	函岛艚
函数计数	函涤
函数覆盖	函岛w
函数声明	函敌告
行数定义；功能定义	函刀x；功能定x
功能键	功能I
函数列表	函当砹
函数对象	函滴锛
	函刀噍dQh程序
函数重载	函刀噍d
函数重写	函蹈
函数描述	函得枥L
函数范围	函倒
函数集	函导
函数模板	函的０澹还δ苣０
函数执行时间	函绦rg
功能性	功能性
函数层连接	函舆BY
函数过程范围	函惦r型
基本类型	基本型式
	未碇
间隙索引	g隙索引
保证	保C
门	l
计量长度	量L度
高斯模糊	高斯模糊
	GPF 一般性保oe`
通用	一般用途
生成器	a生
生成器	a生器
通用算法	同傺菟惴
类属类别设定	同兕eO定
类属合成别号	同俸铣e
类属创建程序	同俳立者
类型	型；L格
获得区域	取回^
获得指针	取回指
苍白	n白
全局默认值	全域AO值
全局对象	全域物件
全局最佳化	全域最佳化
全局规则	全域t
全局脚本	全域_本
全局样式表	全域邮奖
全局变量	全域
光晕	光
字形高速缓存	字符快取
转到	前往
抓取	抓取
抓取句柄	抓取控c
抓取视频帧	抓取框
抓取的帧	抓取框
等级名	等名Q
灰阶分类	灰A分
灰阶选项	灰Ax
灰阶样式	灰A邮
颗粒	w粒；粒罴y理
	粒子化VR
总计	
图形	D形
图形对象	D形物件
图形重叠	D形重B
图像用户界面	D形使用者介面
图形外观	D形外貌
图形设备接口	D形b置介面 
图形说明	D形⑹
灰色检查值	灰核χ
灰色选单项	灰x雾目
灰阶	灰A
灰阶调色板	灰A色P
栅格控制	鸥窨刂
栅格布局	格布局
组；成组	群M
组列表	群M表列
组成员	群M成T
组重命名	群M重新命名
控件组	群M方K控制
保证	保C
代码保护区域	程式a保o^g
保护段落	保o^段
指南	指ЬV要
导则	指
指南	指引
黑客；黑客	客
硬件禁用	硬w失能
一般大小	一半大小
半形	半形
处理器，处理例程	置器
处理锁定冲突	置i定n突
联络	交握
悬挂式缩进	凸排
硬限制器	硬限制器
硬回车	硬D回
硬码	硬a
硬盘驱动器	硬碟C
硬件加速	硬w加速
硬件填充颜色	硬w填色
硬件透明	硬w透通
粗湿	粗
哈希算法	s演算法
哈希多重集	s多重集
哈希数	s
哈希表	s表
散列值	s值
	型
磁头；头[部]	祟^；x^；^端
首部	祟^；表^
标题控制	祟^控制
标题	祟}
堆；堆	堆e
堆分配	堆e配置
强烈模糊	烈模糊
内圆高度	A高度
帮助内容	求助热
帮助映射文件	求助映射n
帮助概要	求助概^
帮助项目文件	求助０n
帮助查找程序	求助搜こ淌
帮助选择	求助x
帮助主题	求助主}
异类的	|的
十六进制转储	十六M位A印
十六元，十六进制	十六M位
隐藏	[藏
隐藏文字	[藏文字
隐藏下阴影	[藏下落式影
层次[结构]	A
高位	高位元
高阶	高A
高亮文本	醒目文字
高亮	醒目
高亮文件类型	醒目的n案型式
高阶字	高A字
嘶声等级	嘶等
嘶声降低	降低嘶
查到；暂扰	c簦幻中
点击计数	c粲担幻中
点击测试	cy；命中y
点击测试代码	cya
按下	按住
持有者	托架；持有者
全息图	全像
家庭视频	家庭
钩连点	r截
	r截函
	r截程序
水平百叶窗	水平百~窗
水平线	水平
水平分辨率	水平解析度
水平滚动条	水平暂S
水平间距	水平g距
水平排列	水平K排
水平停住	水平停v
主应用程序	主用
主控	bd控制
主控能力	bd能力
主控信息	bdY
主机名	主C名Q
热钮	徕o
热键	徭I
按粉红	暗粉t
热点	狳c
沙漏指针	沙漏游
html布局文件	html 布局n案
html清理	html清理
毂；集线器	集器
色调	色{
人可读的	人可x的
超链接地址	超BY位址
超链接基础地址	超BY基底
超链接文本	超文字BY
超文本置标语言	超文字擞Z言
超文本参考	超文字⒖
超文本传输协议	超文字鬏通f定
图标栏	D示列
图标文件	D示n案
图标资源	D示Y源
集成开发环境	整合_lh境
标识符前缀	Re符前Y
标识符文本	Re符文字
识别	Re；身分
识别增量	Re增量
识别分割	Re分割
识别种子	ReN子
空闲	f置
空闲传感器	f置感器
空闲状态	f置B
空闲时间	f置rg
忽略	忽略
忽略大小写	忽略大小
非法	非法的
	影像基底
图像文件	影像n案
图像库	影像D
图像列表	影像表列
图像记录	影像器
图像序列	影像序列
图像大小	影像大小
图像编辑	影像
直接变量	直接引
直接基础	直接基A
直接衍生	直接衍生
直接呈现	直接呈F
直接叙述	直接⑹
直接窗口	直接窗
执行	作
执行界面	作介面
执行定义	依作定x
执行者	作者
隐含	入[的；[含的
隐含连接	[含BY
隐含参考	[含⒖
引入数据库模板	R入Y料炷０
引入文件	R入n案
引入函数	R入函
进行中	M行中
非活动	不作用
英寸	英
包含	包含
引入	人
递增运算符	f增\算子
增量备份	f增浞
递增构建	f增建置
递增连接	f增BY
递增连接器	f增BY器
递增搜索	f增搜
递增状态文件	f增Bn案
缩进空格	s排空格
独立软件供应商	立wS商
索引顺序存取法	索引循序存取法
索引视图	索引z
索引子	索引子
索引子回传类型	索引子骰匦褪
显示	指示
指示器，指标	指示器；指示符
	指示器限
间接内存运算	g接\算元
间接法	g接法
个人模板	人模板
推理规则	推理t
无限大	o限大
无限递归	o限f
中缀记法	字g法；中置法
	商IYV告
信息；信息；信息；信息	Y
信息内容	Y热
信息流	Y流
信息模型	Y模型
继承循环	^承循h
继承层次	^承A
初始容量	初始容量
初始化文件	初始化n案
初始化	初始化
 初始化表达式	初始器
初始化传真	初始化髡
墨水瓶	墨水瓶
嵌套	套
行内组合器	行冉M合器
行内组合码	行冉M合程式a
行内展开	行日归_
行内档案	行n案
行内函数	行群
行内脚本	行饶_本
行内式样	行仁
内斜角	刃苯
内部类别	炔款e
内部例外	炔坷外
内并[符]	炔柯合
内阴影	炔筷影
内宽度	炔度
就地启动	就地
就地启用	就地⒂
就地按钮	地按o
处理中	理中
处理中组件	理中M件
处理中调试	理中慑e
处理中服务器	理中伺服器
输入	入
输入焦点	入焦c
输入位准	入位
输入法编辑器	入法器
输入来源	入碓
插入颜色	插入色彩
插入颜色	插入
插入数字	插入底
插入查询	插入查
插入结果	插入Y果
插入值查询	插入值查
插入列	插入
填充列	填M
可插入对象	可插入物件
嵌入浮雕	嵌入浮凸
嵌入路径	插入路
内部程序	炔砍绦
内实线	
检查	z
实例处理	例置
实例方法	例方法
实例变量	例
实例模型	例模型
	例F隹刂
实例模版	例影
例示	例化
电气和电子工程师协会	子C工程W
指令安排	指令排程
整型	整敌褪
综合服务数字网	整w服滴痪W路
饱和度	(色彩)和度；度
	度立wa
拦截器	r截器
互联方案	互B方案
接口定义语言	介面定xZ言
接口文件	介面n案
接口ID	介面Re符
接口标识符	介面Re符
接口类型	介面型式
集成	整合
集成电路	ew路
	染吧彩
隔行	交e
交错效用	交e效用
交错	交e
中间目录	中g目
中间事件	中g事件
媒介(中间)语言	中介Z言
内连接	炔挎Y
	炔客顿Y蟪曷
国际设定	HO定
互联网络控制报文协议	WHW路控制息通f定
互联网络工程任务小组	WHW路工程任招〗M
互联网络包	WHW路封包
互联网络服务器应用编程接口	WHW路伺服器用程式l展介面
互联网络服务器扩充	WHW路伺服器U充
互联网络服务器过滤器	WHW路伺服器^V器
因特网服务提供方	WHW路服展商
内插	炔
解释器	解g器
中断	中啵徊
交	交集
间隔	g隔
固有常数	冉ǔ
固有控件	冉控制
固有函数	冉ê
无效字符	o效字元
无效文件名	o效n名
无效分页错误	o效分e`
不因国别而异	不因e而
不变表达式	不量\算式
不因语言而异	不因Z言而
大小写互换	大小互Q
颠倒深度	倒深度
反相选取	反相x取
启用	挑取；{用
因特网协议（IP）地址	IP 位址
因特网协议（IP）编号	IP 
ISAPI扩充精灵	ISAPI U充精`
ISAPI过滤器	ISAPI ^V器
隔离存储区	隔xΥ^
隔离等级	隔x等
问题详细表	h}表
发行者	l出者；l卡挝
问题列表	h}表列
项目目录	目目
项目扩展	目延伸
项目文件名	目n案名Q
项目路径	目路
项；项	目
迭代	迭代
迭代	迭代
迭代	迭代器
不规则数组	不t列
堵塞循环	堵塞圈
微动	微
并，联结	Y；合
连接条件	Yl件
联结线	Y
连接运算符	Y\算子
联合立体声	合立w
操纵杆	uU
换碟机	光碟；c唱C
跳[转]  ；跳[转]	跳越，跳位
	跳越⑹鍪
跳转到	跳到
连接资料表	YY料表
整版；调整	R；{整
JustLink刻录技术	JustLink技g
保留外观	保留外^
保留签出	保留出
紧排	B排
键框	I框
密钥对	金
密钥设定	金O定
密钥验证	金C
健值	PI值；I值
键盘语言及布局	IPZ言及布局
键盘布局	IP布局
键盘布局文件	IP布局n案
退色效用	褪色效用
小键盘	底宙IP；小IP
关键字编辑器	PI字器
关键字文字	PI字文字
刀；美工刀	美工刀
知识库	知R
知识库文章	知R煳恼
知识工作者	知R工作者
标号；标号	颂；嘶`
有标磁盘	有舜诺
有标叙述	有⑹
计算机科学实验室	X科W室
λ表达式	λ表式
LAMP网络平台技术(Linux + Appache + MySQL + PHP/Perl)	LAMP W站平台
横[长]式	M式
语言邦定	Z言MY
语言元素	Z言元件
语言对等	Z言Φ
语言标识符	Z言Re符
	Z言中性
大图标	大D示
大规模集成电路	大型ew路
激光	雷射
激光碟片	雷射唱片；雷射唱P；影碟片
套锁工具	套索工具
最后	最後
最后修改	最後修改
最后位置	最後位置
	延後MY
	延後正化
启活	l
层；层	
分层窗口功能	分右窗功能
布局；布局；布局	布局
布局文件	布局n案
内存布局	w布局
插槽布局	插槽布局
前导位	前位元M
导入	入；引入
导入轨	入
导出	С觯灰出
导出轨	С鲕
行距	行距；前
前导零	前Я
叶	~c
学习版	W版
租用	租用
最低有效位	最低有效位元M
左对齐	靠左R
左箭头	左箭^
左键双击	左I按二下
	靠左校正
左键	左I
左边界	左限
鼠标左键	滑鼠左I
左连接	左外部Y
合法的	合法的
合法著作权	合法著作
合法声明	法律明
合法商标	合法商
长[度]	L度
字母	字母；信
级[别]；层	等；蛹；哟危晃剩活e；；樱晃浑A
词汇分析器	Z》治銎
词汇范围	Z」
词汇空间	Z】臻g
库管理员	程式旃芾碚
[文件]库	程式
库文件	程式n案
库版本	程式彀姹
许可	授
许可证协定	授嗪霞s
授权处理器	授嗵理器
授权方案	授喾桨
寿命	生命期
轻微模糊	p微模糊化
亮度	亮度
轻量	p量
轻量控制	p量控制
	p量型h端程序呼叫
限制	限制
线路；行	；M列；行
断行	嘈
行计数	行
行覆盖	行涵w
下移一行	下移一行
行尾	行尾Y束
行号；线路[编]号	行
	行剖L
行范围	行
换行符	行分隔符
行终端	行K端符；K止器
直线工具	直工具
	NR
	性化表格
	行Bm字元
隔行	跳行
隔行字符	跳行字元
行模式	行模式
行模式浏览器	行模式g[器
链接图表	BYD表
链接文件	BYn案
链接格式	BY格式
链接对象	BY物件
链接来源	BY碓
链接文字	BY文字
链接时间；链接时间	BYrg
链接精灵	BY精`
链接/读入/读出	BY/x入/x出
链接要求	Y格
基础链接	BY基A
链接项目	BY目
链接[列]表    	接串列
链接对象	BY物件
链接样式工作表	BY式庸ぷ鞅
链接表管理器	BY表管理者
链接窗口框架	BY窗框架
链接窗口	BY窗
链接器	BY器
链接与嵌入	BYc嵌入
链接元素	BY元件
链接库	BY程式
链接	BY
链接条	BY列
Linus Benedict Torvalds(Linux内核创始人)	托瓦 (Linux核心的l明人)
Linux  操作系统	Linux 作I系y
Linux开发平台规范	Linux_l平台格
Linux内核	Linux核心
Linux标准基础	Linux 驶A
列出帮助主题	列出f助主}
	串列理Z言
列表视图控件	列表z控制
列表框控件	列表方K控制
收听	收
收听模式	收模式
收听者	收者
收听者应用	收者用
收听者服务	收者服
文字	字面文字
文字常数	字面文字常
	字面文字w值
装入；	d入；荷
载入行为	d入行
载入有效位指令	d入有效位址指令
负载因素	d因
载入图标	d入D示
按需载入	需要d入
启动时载入	rd入
载入调色板	d入{色P
载入图片	d入D片
载入时间	d入rg
已载入	已d入
载入状态	d入B
局部，本地	^域；本地；本C
局域网	^域W路
本地类别	本地e；^域e
本地拷贝目录	本地副本目
本地文件	本Cn案
	本地^域W路
本机	本C
本地模式	本地模式；本C模式
本地命名	本地名Q
本地对象	^域物件
本地部件	本C部件；本地部件
本地路径	本地路
本机端口	本CB接埠
本地项目	本地０
本地远端程序呼叫	本地h端程序呼叫
本地资源	本地Y源
本地范围	^域
本地服务器	本地伺服器
局部变量	^域担槐镜刈
本地WEB应用	本地W站用
本地WEB服务器	本地W站伺服器
本地环境	本地h境
本地环境标识符	本地h境Re符
	本地h境特定
本地化	可本地化
局部化	本地化
本地化	本地化
本地化文件	本地化n案
	本C的快取副本
	^域
	位置方K
	位置中帱c
	位置Y
锁定控件	i定控制
锁定计数	i定
锁定位置	i定位置
锁定项目	i定０
锁定信息文件	i定Yn案
锁定模式	i定模式
锁定违规	i定`
锁定形式	i定型式
[记]日志；[记]日志；日志	日I；存；
日志文件	日In案
日志查看器	日Iz器
对数	
日志文件	日In案
逻辑	
逻辑差错	e`
逻辑笔刷	P刷
逻辑色板	色板
逻辑连接	B接
逻辑坐标系统	座讼到y
逻辑和	和
逻辑等价	等r
逻辑字体	字型
逻辑隐含	[含
逻辑行	行
逻辑运算符	\算子
逻辑移位	移位
逻辑单元	卧
逻辑视图	z；^c
注册	登入
注销	登出
长日期格式	L日期格式
长文件名	Ln名
长整数	L整
厂指针	L指
查找	查找
查找表	查找表
循环	圈；路
循环构造	圈造
	圈外提
循环干扰	路干_
循环最佳化	圈最佳化
循环	循h
松耦合	散耦合
松开	_
损失	漏失
重要损失	重要漏失
无损压缩	o漏失嚎s
有损压缩	漏失嚎s
低序位	低序位
低功耗	低功率消耗
低阶	低A
下阶	下限
	照度
机器码	C器a
数据来源名称	Y料碓疵Q
机器可理解的	C器可理解的
宏[定义]	巨集
	巨集定x
宏扩充	巨集展_
	巨集g[器
	巨集表列
	巨像素
	巨集υ
魔棒工具	魔g棒工具
放大	放大
邮件服务器	]件伺服器
邮件系统	]件系y
邮箱	信箱
邮递清单	]寄名
主应用窗口	主用窗
主控制器	主控制器
主窗口	主框架窗
主存储器	主w
抓选单	主x
主消息循环	主息圈
主路由	主路由
主表	主表
主表选取对话框	主表x取υ方K
主线程	主绦芯w
主机，特大型机	大型X
维护程序	So用公用程式
主要版本号码	主要版本a
制作插件	u作增益功能
制作备份	u作副本/浞
项目精灵	０妇`
手册页	手皂
可管理的服务	可管理的服
管理	管理
管理能力	管理能力
管理界面	管理界面
管理政策	管理政策
管理语义	管理Z意
管理器，管理程序	管理者
	Z
手册	手裕皇
手动配置	手咏MBO定
手动链接	手舆BY
制造商	u造者；u造商
多对多联系	多Χ嚓PS
映射；映射；映像	τ常D；映射
映射文件	τn案
映射网络	τ尘W路
映射网络驱动器	τ尘W路磁碟C
映射网络资源	τ尘W路Y源
映射	τ常挥成
机读目录记录	Cx目
版口，页边空白	限
	限指示符
加标[记]	擞
标记符；标记符	苏I
标记声明	耸拘告
置标语言；置标语言	耸菊Z言
置标模型	耸灸Ｐ
跑马灯控件	跑R艨刂
	M理
屏蔽；掩码	遮罩
屏蔽位图	遮罩cD
屏蔽层	遮罩
屏蔽区	遮罩^
屏蔽编辑控件	被遮罩控制
大量存储设备	大量Υ嫜b置
光盘母片	光碟母片
比对	匹配；符合
成对括号	成括
匹配大小写	大小符合
前缀匹配	前Y符合
子字符串匹配	子字串符合
仅限全字匹配	H限全字拼符合
调色板	色版
最大混合	最大混合
最大化按钮	最大化按o
最大化窗口	最大化窗
最大	最大
最大位数每秒	最大每秒位元M
最大传输单元	最大鬏卧
最大错误数	最大e`量
多媒体控件界面	多媒w控制介面
多文档界面	多重文件介面 
被测事件	被y量事件
测量单位	y量挝
机制	C制
媒体布局	媒w布局
媒体,介质；媒体；媒体；中[间]	媒w；媒介；中等的
中度模糊	中度模糊化
成员；成员	成T
成员存取操作	成T存取\算子
成员函数	成T函
成员初始化列表	成T初始化表列
成员名称	成T名Q
成员选项	成Tx
成员形式	成T型式
成员变量	成T
成员存取控制	成T存取控制
成员资格条件	成TY格l件
成员逐一	成T逐一
成员逐一复制	成T逐一}u
备忘录	渫
内存分配	w配置
内存块	w^K
内存高速缓存基础物体	w快取基底物件
内存布局	布局
内存泄露	漏失
存储器模型	模型
	物件
内存使用差异	使用差
选单	x
启动选单	x
选单外观	x瓮庥^
选单条	x瘟
选单控件	x慰刂
选单项	x雾目
选单编号	x翁a
选单编程	x纬淌郊
选单资源	x钨Y源
选单缩图	x慰sD
选单项目识别符	x雾目Re符
归（合）并	合
消息，报文；消息，报文；消息，报文；消息，报文	息
消息框	息方K
消息断点	息中帱c
消息相关	息相P
消息交换样式	息交Q型
消息文件	息n案
消息过滤器	息^V器
消息处理器	息置器
消息处理	息置器
消息头	息祟^
消息循环	息圈
消息映射	息τ
消息封装	息封b
	息推
消息队列	息辛
消息接收者	息接收者
消息反射	息反射
消息可靠性	息可靠度
消息发送者	息l送者
消息汇（宿）	息槽
消息传输	息鬏
消息驱动	息
消息处理函数	息置函
消息映射入口	息τ稠
消息映射巨集	息τ尘藜
信息应用编程接口	用程式_l饔介面
元标签	元嘶`
元字符	元字元
元内容	元热
元数据	後OY料
元文件	後On；元n案
仪表控件	量表控制
方法	方法
度量	度量
微电脑	微X
小额付款	小~付款
毫秒每桢	每框毫秒
鼠标中键	滑鼠中I
中层	中
中阶	中A
转移精灵	D移精`
小型转储	小型A印
最小重建	最少重建
厘米	米
次版本号码	次要版本a
分钟	分
镜像	R像
镜像显示字体	R像@示字型
镜像列表	R像表列
镜像站点	R射W站
杂项	s
不匹配	不匹配；不符合
丢失	z失
混合内容	混合热
混合式启动	混合式
混合模式光盘	混合模式光碟
	助符
模态	模B
模态	模B
模型	模型
模型邦定表达式	模型MY表示式
模型项目	模型目
模型项目属性	模型目性|
模型理论	模型理
非模态	o模式
非模块形式	o模式形式
建模；建模，造型	塑模
建模语言	塑模Z言
建模工具	塑模工具
调制解调器	C
调制解调器连接	CB接
修饰符	修符
修饰符键	修符I
修改	修改
模块化	模M化
模块化模型	模M化模型
模块；模块	模M
模块定义文件	模M定xn案
模块层次	模M哟
单音	我
单语言	握Z言
等（间）距字型	等字型
单调	握{
月历控件	月芽刂
	最末衍生e
	最高有效位元M
主题资源管理器	主}Y源管理者
主题窗口管理器	主}窗管理者
移动按钮	移影粹o
移动指南	移又敢
移动选单	移舆x
	幼餮ag
装定夹；装[上]	燧d
鼠标捕捉	滑鼠捕捉
鼠标事件	滑鼠事件
鼠标消息	滑鼠息
鼠标指针通知	滑鼠指烁嬷
鼠标目标	滑鼠目
移动文件	移n案
移动文件夹	移淤Y料A
工具下移	工具下移
工具上移	工具上移
电影识别标签	影Re符嘶`
MPEG音频层	MPEG 音
分秒桢位置	分秒框位置
多重会话	多重
多位字符集	多位元M字元集
多位编码页	多位元Ma
组（多）播	多播
多码引入引出	多aR入/R出
多维	多S
多语言	多Z文
多行编辑控件	多行控制
多语言	多Z文
多链路连接	多重BYY
多重映射	多重τ
多媒体控制	多媒w控制
多重	多重
多文档界面	多重文件介面
多文档类型	多重文件型式
多文件	多重n案
多选	多重x
多行编辑控件	多行控制
多选列表框	多重x癖砹蟹K
[多路]复用	多工
复用器	多工器
乘法	乘法
乘法运算符	乘法\算子
多协议传输网络	多f定鬏W路
多用途的网际邮件扩充协议	多用途WHW路]件延伸
多重集合	多重集合
多线程	多重绦芯w
	多重绦芯w^K模型
多线程应用[程序]	多重绦芯w用
多用户	多使用者
多用户环境	多使用者h境
多重视图	多重z
多卷压缩	多卷嚎s
音乐片段	音菲段
音乐视频	音芬
静音	o音
互斥物体	互斥物件
互斥	互斥
名称	名Q
名称修饰	名Q修
名称空间	名Q空g
命名变量	具名引
命名书签	具名`
命名类别	具名e
命名参数	具名
命名许可集合	具名S可集合
命名管道	具名管道
命名序列	具名序列
名称空间污染	名Q空g污染
名称空间前缀	名Q空g前Y
名称空间有效	名Q空g有效
名称空间验证	名Q空gC
名称空间合格	名Q空g合格
命名规定	命名s
命名方案	命名方案
国家语言支持	家Z言支援
本原	原生；固有
本原音频	原生音
本原[代]码	原生a
本原编译器	原生g器
本原数据	原生Y料
本原错误	原生e`
自然语言	自然Z言
自然	本|
导航列图象	в[列影像
导航	в[
向后导航	向後в[
向前导航	向前в[
导航；导航；导航	в[
导航条	в[列
导航机制	в[C制
导航结构	в[Y
近指针	近指
协商内容	f商热
	f商後OY料
嵌套	巢套
网	W
网络新闻传输协议	W路新
网络新闻传输协议	W路新魉f定
网络适配器	W路配接器
网络地址转译	W址Dg
网络字节序	W路位元M次序
网卡	W路卡
网络连接	W路B接
网络文件系统	W路n案系y
网络信息服务	W路Y服
网络负载平衡	W路d平衡
网络服务提供者	W路服仗峁┱
网络组件	W路M件
中性	中性
换行字符	Q行字元
结点；结点；结点	c
正常	正常
正常按钮	正常按o
正常拖拽	正常拖曳
正常执行	正常绦
正常初始化	正常起始
正常选择	正常x
正常大小	正常大小
正常窗口	正常窗
规范文字	的文字
记法	法
记法声明	法宣告
注解	淇迹辉]解
笔记本电脑；笔记本	P型X；P本
通知信息	通知息
通知服务	通知服
通知	通知
[逐像素]挪动	p推；微{
稍微增加宽度	微增度
稍微上调	向上微{
空值	空；空值
空语句	空⑹
辅助位数	o助位元
每像素位数	每像素位元
每样本位数	每颖疚辉
拷贝数	拷
帧数	框
每块帧数	每^K框
平面数	平面
流数	串流
初始帧数	初始框
数值	抵
数值表达式	抵当硎臼
数字小键盘	底宙I台
数值参数	抵
数[字]类型	抵敌褪
客体；对象；客体	物件
基于对象	基於物件
对象浏览器	物件g[器
对象浏览器过滤器	物件g[器^V器
目标[程序]码；目标[程序]码	目的a
对象描述语言文件	物件描述Z言n案
对象表达式	物件表示式
目标文件	目的n案
对象层次	物件A
对象库	物件程式
OLE	物件BYc嵌入
对象映射	物件τ
对象模型；对象模型；对象模型	物件模型
目标模块	物件模M
对象模型格式	物件模M格式
对象向导	物件向
	物件集^
对象性质	物件性|
	物件限定符
对象状态	物件B
对象类型	物件型式
对象变量	物件
对象视图	物件z器
面向对象的设计	物件向O
义务	x
八元；八进制	八M位
离线操作	x作I
离线发布	xl行
离线复制	x}u
在线	上
操作中处理	\作中
	步{一致
一对多联系	一Χ嚓PS
一对一联系	一σ魂PS
	描D
屏上键盘	幕IP
面向对象编程	物件向程式O
不透明度	不透明度
ODBC；公共数据库接口	_放式Y料爝B接
开启独占权限	_嘞
开放信息模型	_放Y模型
开放服务架构	_放服占
开放软件说明	_放wf明
开发软件基金会	_放w基金
开放声音系统	_放音系y
开放源码	_放源a
开放系统互连	_放系y互B
开口标签	_^嘶`
操作数	\算元
操作码	操作a
操作环境	作Ih境
操作	作I；操作；\算
操作失败	作I失
操作系统	作I系y；操作系y
运算符	\算子；\算符
运算符前置	\算子居先
开放式	_放式
开放式并行	_放式K行
开放式锁定	_放式i定
最佳化	最佳化
最佳化中继语言	最佳化中^Z言
最佳化提示	最佳化提示
选项	x裥裕贿x
选项参数	x裥砸
选项行为	x裥孕
选项特征	x裥蕴蒯
次序;排序	次序；排序；命令；A
有序	有序
序数	序
序数索引值	循序索引值
序数号码	序堤a
指向	定向；指向
原创者	原者
原始服务器	原始伺服器
原始终点	原始Kc
原始路径	原始路
原始设定	原始O定
原始位置	原始位置
原始起点	原始起c
示波器	示波器
发件箱	l信匣
内存不足	w不足
输出	出；流出
外斜角	外斜角
外部连接	外部合
外部类型	外部型式
外部宽度	外部度
外部高亮度	外部高亮度
外部阴影	外部影
外部样式	在外邮
输出	出；外送信件
输出界面	出介面
大纲	大V；外框；廓
仅输出	H出
输出	出
输出阶层	出A
输出模态	出模B
输出参数	出
输出单精度	出精识
输出流	出串流
输出窗口	出窗
外部程序	外部程序
外部区域	外部^域
超量刻录	超量
超量刻录光盘	超量光碟
超量写录	超量
溢出	溢位
	突出部分
	~外
重叠音频	重B音
重叠窗口	重B窗
覆盖[程序段]；覆盖表格	覆w
覆盖图片	覆w影像
覆盖模式	覆w模式
覆盖字幕	覆w字幕
超载；过载	超d；^d
过载解析	超d解析
重载函数	重d函
重载运算符	重d\算子
重载集合	重d集合
超载；过载	超d；^d
重写	置Q；改
超量刻录	超量
复写	覆；重打
概况	概^
复写	覆
所属窗口	所僖窗
拥有者	碛姓撸恢骺卣
主控窗口	主控窗
	主控描L控制
	主控描L按o
所有权	所有啵碛
包装	包b；嚎s
包；打包	套b；套件；封b
打包与部署精灵/向导	封b暨部署精`
封装函数	封b函
打包向导	封b精`
封装IP地址	封b IP 位址
打包	封包
打包整合	封包整合
PING	WHW路封包探索
打包交换	封包交Q
打包写入	封包入
填充	填a；填塞
填充区域	填a^K
填充粒度	填a粒度
关闭填充	P]填a
开启填充	_⑻钛a
分页	分
页设计者	WO者
页错误差异	分e`差
页文件位组	分n案位元M
置入页面	置入面
页面布局	面布局
移出页面	移出面
页面设置	面O定
页面转换	面DQ
页面视图	面[
	分捍^
	分器；呼叫器
油漆桶工具	油漆桶工具
调色板	{色板；色P
调色板映射	色Pτ
调色板设定	色PO定
	香港版
窗格	窗格
面板布局	面板布局
面板设置	面板M合
	全景z影
	A
段落格式	段落格式
段落分隔符	段落分隔符
平行	平行；K列
参数数组	店列
参数	
参数块	^K
参数数据成员	蒂Y料成T
参数实体	w
参数传递	鬟f
参数前缀	登爸
参数设定	翟O定
参数后缀	滇嶂
参数实体参考	w⒄
参数型命令	敌兔令
父	H；父；上
父类	上宇e
上级目录	上幽夸
上级文件类型	上游募型式
上级表单	上颖
上级项目	上禹目
上级选单	上舆x
上级对象	上游锛
上级页面	上禹面
上级程序	上映绦
上级表	上颖
父窗口	上右窗
父子关系	H子PS
奇偶标志	同位旗
解析影射	剖析τ
已解析字符数据	已剖析字元Y料
以解析实体	已剖析w
解析器	剖析器
先行解析错误	先行剖析e`
解析	剖析
部分	零件；部分
部分相等	部分相等
局部特殊化	局部特殊化
局部理解	部分理解
参与	⑴c
粒子大小	粒子大小
粒子	粒子
分区	分^；分割
地址传递	按址鬟f
参考传递	按⒖鬟f
值传递	按值鬟f
	通P密Z
被动	被
被动模式	被幽Ｊ
传递查询	鬟f查
密码验证协议	密aCf定
密码列表	密a表列
粘贴为	N上成
补丁	修a；修a程式
路径	路
路径括弧	路嚼弧
	P刷感工具
路径深度	路缴疃
路径名	路矫Q
样式	型樱D
样式匹配	型悠ヅ
样式字符串	型幼执
暂停	和
负载安全性	d安全性
虚拟码	Ma
峰	峰
峰值分页文件位	峰值分n案位元M
峰值虚拟位	峰值M位元M
峰值工作集	峰值工作集
对等仪表板	Φx表板
对等网络	ccW路
笔	P
铅笔	UP
搁置	R置
搁置项目	R置目
半影	半影
可感知单元	可感知卧
百分比位置	百分比位置
执行	履行；绦校施
性能	效能
性能监视器	效能O器
期间	期g；L期
周边	L
周边组建互连	LM件B接
周边设备	Lb置
永久	永久；常v
固存	永久Υ嫫
许可	S可；嘞
许可防护	S可防o
	型式Z意
许可	S可
保存	保存
持续	持m
固存	永mΥ嫫
个人	人
个人认证	人JC
个人数据处理器	人Y料理器
个人数码助手(PDA)	人滴恢理
个人文件	人n案
个性	性
	透扭曲
封闭式	封]式
封闭式锁定	封]式i定
阶段	A段；相位
拼音建议	拼音建h
假性目标	假性目
相片	相片
物理地址	w位址
物理笔刷	wP刷
物理设备	wb置
物理字型	w字型
物理内存	ww
图片	D片
图片框	D片方K
图片渲染	D片渲染
管	管；Ч
管线	管
间距	g距；定音
	屑~z
像素	像素
	像素重覆
预留位	孜环；A留位置
预留位置形状	A留位置形
纯文本	文字；本文；明文
平台	平台
互联网络内容选择平台	W路热莺Yx平台
播放	播放
回放	播放
倒放	倒放
即插即用	S插即用
插件	外
口袋书	口袋
点	c
关注点	注c；c
指针	指
指针部分	指瞬糠
指针速度	指怂俣
数据指针	Y料指
数据成言指针	Y料成T指
成员指针	成T指
成员函数指针	成T函抵
指针轨迹	指塑E
指针类型	指诵褪
点对点协议	ccf定
政策	政策
政策防护	政策防o
多边形模式	多形模式
多边形工具	多形工具
多边形填充模式	多形填M模式
多型	多型
	捍^的
弹出式选单	出式x危豢祜@x
弹出式窗口	出式窗；快@窗
端口	埠
端口名	埠名Q
端口号	埠a
便携式	可y式
PNG	可y式W路D形
便携式操作系统见面X	可y式作I系y介面X
部分	部份
	直式；肖像式
位置	位置
张贴；投递	N
后文	後文；跋
	後建置
	後置法
	後置g隙
	事後剖析慑e
	延後
潜力	力
功率校正	功率校正
节约能源	s能源
节能模式	能模式
电源方案	源方案
电源供应	源供
	MA使用者
实践	
先行版	先行版
序	前文；序
	前置放大
前置缓冲器	前置n器
	前建置
	前置元件
精确游标	精_游
精确度	精_度
先行编译	先行g
	先行g祟^指示
	A先M成字元
预定义	A先定x
断言	述~
预测	Ay
	A先加
	偏好b置
	偏好
前缀	前置；前Y
前缀符号	前置法
	前置g隙
预连接	A先BY
预载	Ad
	前置主控
预处理	前置理
预处理器	前置理器
	先Ql件
保留	保留
预设	AO
按	按；海怀霭嫔
	良好[私系y
预览	A[
	首要
	首要c型式
打印跨页	列印跨
打印管理器	列印管理者
打印缩放	列印s放
	列印多工n器介面
打印区	列印^
打印	列印成品
优先权	先啵先等
隐私	[私；私密
	私密{C
	私密政策
私钥	私密金
	Ｓ梅獍
私有变量	私用
特权	特
	有特嗟淖髡热
	可享特嗟rg
过程	程序
过程ID	程序Re
继续	^m；_展
处理	^程；理；理程序
处理指令	理指令
产品	a品；乘e
产品Key	a品金
生产	生a
产能组件	a能M件
产能工具	a能工具
	剖L；O定n
	剖L器
	剖L
可编程的	可程式化
程序ID	程式ORe
程序员	程式O
编程	程式O
进度条	M度列
渐进式	uM式
渐进式选项	uM式x
项目日志	０溉照I
放映机	投影C
提示	提示；提示入
提示字符串	提示字串
证明	C明
所有权证明	所有嘧C明
属性定义	性|定x
	已提案推]
	提案推]
	命}
保护	保o
协议	f定
原形	原型
	分度器
证明	C明
提供者	提供者
代理商	供商代理
供应实体	供w
近似位置	近似位置
代理	代理；代理伺服器
代理服务器	代理伺服器
虚拟码	Ma
虚拟列	M行
	MM理
	MSC
虚拟目标	M目
公开	公用；公_
公用文件夹	公用Y料A
公开识别符	公_Re符
公钥	公_金
公钥密码学	公_金密aW
	公_金基A建O
公用物体	公用物件
公共在线论坛	上公共
公用程序	公用程序
公共用户	公用使用者
出版物	出版品；l行物
发布	l表；l布
发布者	l表人；l布者；出版商
脉冲	}n；}波；鼙P式
打孔	打孔
标点符号	它c符
目的	目的；意D
合格	限定；合格
合格名称	合格名Q
限定符	限定符
合格	限定；合格
质量	品|
质量保证测试套件	品|保Cy套件
质量保证测试套件	品|保C
服务质量	服掌焚|
排队	辛
查询	查
排队传真	辛髡
排队名称	辛忻Q
快速启动	快速_
快速记录	快速u
快速审查	快速z
快速执行	快速绦
快速擦除	快速抹除
配额	配~
引言	引用；引言
引号	引
引号识别符	引Re符
	引瓤闪杏
加上引号	加上引
引号级别	引蛹
放射状布局	放射畈季
无线	o；o
单选按钮	芜x按o
单选按钮	芜x按o
半径	半
基数	基
突起浮雕	凸起浮雕
随机	SC
随机存取内存	SC存取w
随机水平条	SC水平l
随机垂直条	SC垂直l
随机溶解	SC溶解
随机数	y
随机化	SC化
随机列表	SC表列
随机数产生器	y诞a生器
范围值	值
排位；等级	A；等
快速应用开发	快速用程式_l 
光栅	光
光栅显示器	光棚@示器
光栅字型	c字型
光栅运算	光胚\算
光栅格	鸥窕
	c化文字
比率	比率；速率
分级	分
分级	分；~定值
原始的	原始的；未理的
原始数据	原始Y料
	原始介面指
读	x取；x
预读取缓冲区	A先x取n^
读者	x者；x取器
说明	x我n案
就绪	就w；渫
真实模式	真模式
即时视频	即r
接收	接收
接受者	接收者；接收器
认可	辨R；Re
推荐	推]；建h；推]
重新连接	重新B
调解	{解
记录	；u
记录按钮	按o
记录分隔符	分隔符
记录字段交换	谖唤Q
记录审查	z
录制旁白	u旁白
录音机	器
恢复	恢
矩形工具	矩形工具
矩形数组	矩形列
矩形坐标	矩形座
递归	f
	重新芴
重定向	重新向
重定向方案	重新向方案
重定向脚本	重新向_本
重绘	重L
减少	sp；s小
精简指令集电脑	精指令集X
参考	⒖迹⒄
参考完整性	⒖纪暾性
反射	反射
刷新速率	重整速率
区域	^域
寄存器	捍嫫鳎辉]
寄存器存储类别	捍嫫Υ骖e
寄存器变量	捍嫫髯
寄存器窗口	捍嫫饕窗
注册资料库	]再Y料
注册脚本	]阅_本
注册应用程序	]用程式
注册	]裕坏怯
注册数据库	]再Y料
规则事件	t事件
正则表达式	正表示式
正则表达式对象	正表示式物件
	具w化
相关章节	相P章
关系	PS
关系数据库	P式Y料
关系运算符	P式\算子
相对连接	相BY
相对路径	相β
相对区域	相Υ^
相对时间	相rg
释放	放；l行
发行版	l行版
可靠性	可靠度；可靠性
剩余	剩N
剩余时间	剩Nrg
备注	湓]
远程存取服务	h端存取服
远程电脑	h端X
远程连接	h端B
远程数据控制	h端Y料控制
远程数据对象	h端Y料物件
远程数据服务	h端Y料服
远程调试监视器	h端慑eO器
远程调试	h端慑e
远程磁盘	h端磁碟
远程机器	h端C器
远程管理	h端管理
远程程序呼叫	h端程序呼叫
远程资源	h端Y源
远程侦测	h端感y
远程服务器	h端伺服器
重命名文件	重新命名n案
重新排序	重新排序
修复	修
重复	重}
重复次数	重}次
全部替换	全部取代
重新播放	重新绦校恢匦虏シ
复制	}u
复制管理器	}u管理器
回复	回覆
回复地址	回覆位址
报告	蟾
报表集合	蟊砑合
仓库	Υ
仓库引擎	Υ煲擎
表示	表示
请求	求
请求评论	求u
重新取样	重新取
废除推荐	U止推]
保留	保留
保留区域	保留^
保留大小	保留大小
重置	重置；重O
决议	解析度；Qh
决议运算符	Qh\算子
资源	Y源
资源浏览器窗口	Y源g[器窗
资源描述框架	Y源描述框架
资源编辑器	Y源器
资源文件	Y源n案
资源标识符	Y源Re符
资源项目	Y源目
资源类型	Y源型式
资源察看	Y源z
资源定义文件	Y源定xn案
回应	回
重新启动	重新
限制	限制；s束
结果集	Y果集
结果确认	Y果_J
重试	重
返回地址	回魑恢
返回码	回鞔a
返回收到	回骰l
返回类型	回餍褪
返回值	回髦
反向文件顺序	反向文件次序
反向递增搜索	反向f增搜
反向扫描	反向呙
反向慢速	慢速反向播放
还原成	原成
修订	修正；修
修订控制系统	修控制系y
撤销	撤N
倒转	В坏罐D
右对齐	靠右R
右边界	右界
鼠标右键	滑鼠右I
风险管理	LU管理
机械的	C械的
卷动	
根	根
旋转	旋D
路由	路由
路由设定	路由O定
例行工作	例行工作；常式
路由	路由；x路
行	列
行指针	列指
	列蛹安全性
	列集合
橡皮图章工具	橡皮D章工具
橡皮筋	橡皮筋
规则	t
尺	尺
运行时间	\行rg
运行时	\行r
运行时	\行rg
运行时间类型信息	\行rg型式Y
仅限运行时	H限\行rg
右值	右值
安全	安全的
安全区域	安全^域
样本	颖荆还例；取
取样深度	取由疃
取样深度缩放	颖旧疃瓤s放
取样大小	颖敬笮
取样	取
取样频率	取宇l率
健全测试	健全y
符合	M足
饱和	和
保存文件	Υn案
文件另存为	n案另存
保存项目	Υ０
项目另存为	０噶泶
保存方案	Υ娣桨
方案保存为	方案另存
选取区域另存为	x取^另存
可缩放	可s放性
可缩放矢量图	可s放向量D
	量字型
	量型式
刻度	硕龋豢潭龋豢s放
缩放属性	s放傩
扫描	呙
扫描码	呙璐a
扫描线	呙杈
扫描仪	呙槠
情景	情景；情
场景	鼍
场景侦测	鼍y
场景索引选单	鼍八饕x
场景选取器	鼍斑x取器
日程	排程
结构描述	概要；V目；Y描述
结构描述设计	Y描述O工具
结构描述编号	Y描述
	Y描述列集
	Y描述Z
方案	方案
科学园区	科W@^
范围	
声明范围	宣告
范围运算符	\算子
范围窗格	窗格
范围解析	解析
范围方案	方案
暂存磁盘	捍娲诺
屏幕坐标	幕座
屏幕放大镜	幕放大R
屏幕阅读器	幕x器
记录员	hT
脚本对象模型	_本物件模型
脚本作者	_本作者
滚动	
滚动快	臃K
滚动条	暂S
密封	密封
无线连接	o接pY
Seamless Link刻录技g	Seamless Link技g
搜索条件	搜l件
搜索准则	搜t
搜索次序	搜ご涡
搜索结果	搜そY果
搜索目标	搜つ
切割	正割
秒；第二	秒；次等；第二
次级	次
次要依赖信息	次要相依Y
次要界面	次要介面
次要语言	次要Z言
节	^段；；段
区域	磁^
安全	保全；安全
安全警告	安全警告
安全设定	安全O定
安全性	安全性；保全
安全监督	安全O督
安全架构	安全架
安全属性	安全傩
安全审核	安全核
安全描述符	安全描述符
安全领域	安全I域
安全标识符	安全Re符
安全机制	安全C制
安全模型	安全模型
安全对象模型	安全物件模型
安全权限模型	安全嘞弈Ｐ
安全政策	安全政策
安全政策表达	安全政策表_
安全服务	安全服
安全支持提供者接口	安全支援提供者介面
安全精灵	安全精`
安全地区	安全地^
亦参见	亦⒄
种子	N子
	段；^段
	^段方案
反向选择	反相x取
选取行	x取行
可选取的	可x取的
自解压的	自我解嚎s
在连接	自我Y
自我参考	自我⒖
语义需求	Z意需求；y嘌
语义WEB	Z意W
语义透明	Z意透明
语义	Z意
旗号	旗
非完全信任	非完全信任
发送	l送
重新发送	重新l送
发送到	魉偷
移到下层	移到最下
发送至浏览器	送至g[器
可发送	可l送
发送者	l送者
敏感性	敏感度
传感器	感y器
分隔符	分隔符；分隔器
分隔线	分隔
分隔字符	分隔符字元
分隔字符	分隔字元
音序器	音序器
序列	序列
有序的	循序
有序容器	循序容器
有序导航	循序Ш
有序评估运算符	循序u估\算子
序列	序列；串列
序列存取	序列存取
序列界面	序列介面
	串列路WHW路f定
序号	序
串口	序列埠
串行传输层	序列鬏
序列化	序列化
系列	系列
系列形态	系列形B
	
服务器应用程序	伺服器用程式
服务器文档	伺服器文件
服务器管理器	伺服器管
服务器扩充	伺服器U充功能
服务器段组件	伺服器端元件
//词语， 不要在第一行增加内从，留给注释用
服务	服
服务组件	服战M件
服务描述	服彰枋
服务接口	服战槊
服务中介	服罩薪
服务提供者	服仗峁┱
服务请求者	服照求者
服务角色	服战巧
服务语义	服照Z意
服务提供者	服仗峁┱
服务导向架构	服向架
会话	^段；
	^段一次 (SAO)
会话ID	^段Rea
会话名称	^段名Q
会话对象	^段物件
置位；设置	O定；集；集合
设定为	O定
设为默认值	O成AO值
设定自动载入	O定自虞d入
设定列标记	O定列擞
设定光盘跳	O定光碟跳S
设定字体	O定字型
集合函数	集合函
设定连接	O定BY
设定选单按钮连接	O定x伟粹oBY
设定选单连接	O定x芜BY
设定打印机字体	O定印表C字型
设定返回到选单	O定返回到x
设定缩图	O定sD
设定控制台	O定控制台
设定电源方案	源方案O定
设定值	O定值
安装/设制完成	O定完成
阴影	影
阴影模糊	影模糊
阴影复制	表友}u
形状	形
形状分类	形罘诸
形状提示	形钐崾