//简体繁体差异词语， 不要在第一行增加内容，留给注释用，3846行开始的是从另一个网站下载的，可能有点问题。
//内容格式为：简体+Tab+繁体
双页	身
A 驱	A 磁碟C
异常运行	常绦
绝对地址	^ξ恢
抽象基底类	抽象基底e
抽象类	抽象e
抽象数据类型	抽象Y料型
抽象宣告符	抽象宣告子
加速键映射	加速Iτ
对应键资源	加速IY源
对应键镜像表	加速I表
访问控制	存取控制
访问时间	存取日期
访问函式	存取函式
访问掩码	存取遮罩
访问模式	存取模式
访问权限	存取S可
访问权限	存取S可
访问权限	存取嘞
访问权限	存取嘞
访问规范	存取
访问时间	存取rg
授权访问	授c存取
访问	存取
访问控件 (ACE)	存取控制 (ACE)
访问范围定义域	存取定x域
可访问性	可存取性
访问子函式	存取子函式
访问子类别	存取子e
附件	附用程式
根据文件	根n案
捕获打印机端口	@取印表CB接埠
动作供应商组件	幼魈峁┱咴件
操作型查询	幼餍筒樵
操作表	幼鞅
激活对象	活化物件
激活要求	活化要求
激活任务列表	活化工作清
激活这个窗口	活化@窗
激活金钥	活化金
激活	活化
激活符	活化子
主动式文档	主邮轿募
主动式 HTML 文档	主邮 HTML 文件
活动窗口的标题列文本	作用中窗的祟}列文字
活动窗口的标题列	作用中窗的祟}列
作用断开点	作用中帱c
作用单元格	作用Υ娓
活动组件	工作元件
主动式内容控制句柄	主邮热菥浔
主动式文件应用程序	主邮轿募用程式
主动式文件伺服程序	主邮轿募伺服程式
主动式文件支持	主邮轿募支援
活动文档	作用中文件
作用中屏幕缓冲区	作用中幕n^
活动状态	作用B
活动窗口的标题颜色	作用中窗的祟}色彩
活动窗口	作用中窗
活动	作用中
实质参量	|引
实质参数列表	|登
广告标志	V告M幅
适配器	介面卡
添加现有项目	加入F有目
添加现有项目	加入F有０
添加文件夹	加入Y料A
添加项目	加入目
添加为	加入
添加驱动程序	加入映淌
添加新项目	加入新目
添加新的项目	加入新的０
添加新的方案项目	加入新的方案目
添加新硬件	加入新的硬w
添加新的	加入新的
增添个人信箱	新增人信箱
添加至输出	加入到出
添加至解决方案	加入到解Q方案
加载功能	增益功能
加载项	增益集
增添/移除	新增/移除
增添/移除程序	新增/移除程式
添加/移除	新增/移除
加法运算符	加法\算子
附加的	~外
加法类运算符	加法\算子
地址簿	通
地址冲突	位址n突
地址模式	位址模式
地址限制	位址限制
编址空间	地址空g
地址空间	位址空g
地址	位址
编址	定址
取地址运算符	取址\算子
编址模式	定址模式
编址	定址
调整列宽	{整谖
系统管理人帐户	系y管理人ぬ
高级	MA
跟踪服务	售後服
代理程序	代理程式
汇总数据区域	】Y料谖
汇总对象	】物件
警报	警示
警报框	警示方K
算法	演算法
居中对齐	置中R
左对齐	靠左R
右对齐	靠右R
均匀排列	NR格
全部文件	所有n案
全部类型	所有型
已被删除	已移除
替代文本	替代文字
模棱两可	模煽
模棱两可的表达式	模煽傻倪\算式
模拟	比
模拟数字	比滴
动画光标	赢游
动画控件	赢控制
附注	附]
匿名登录	匿名登入
匿名类	匿名e
ANSI 字符串	ANSI 字串
应答方式	答模式
开始应答	立即答
应答超时	答逾r
应用程序工作区	用程式工作^
应用程序类	用程式e
应用程序框架	用程式框架
应用程序队列	用程式辛
应用程序逐步解说	用程式逐步解f
应用程序	用程式
压缩文件	嚎sn案
确实要更改	_定要更
确实要	_定要
参量常量	引党
参量宏	引稻藜
参量类型	引殿型
参量类型	引殿型
参量	引
排列数据表	排列Y料表
排列图标	排列D示
排列选定范围	排列x取
数组共异变量	列共
数组指标	列指
数组类型	列型
数组组织	矩式M
数组	列
箭头键	方向I
人工智能	人工智慧
艺术家名	演出者名Q
ASCII 字符	ASCII 字元
汇编语言	M合Z言
分配运算符	指派\算子
分配运算符	指派操作子
分配陈述式	指派述式
分配	指派
相关扩展名	P的副n名
非同步调用	非同步呼叫
音频压缩器	音嚎s器
音频文件	音
音频格式	音格式
音频	音
音频视频交错 (AVI)	音交e (AVI)
证实	C
已证实	已C
正在证实	正在C
证实方案	C方案
证实	C
自动显示数据提示	自语@示Y料提示
自动配置	自咏MB
自动对象	自游锛
自动保存类	自Υ骖e
自动变量	自幼
自动分配	自又付
自动连接	自舆B
自动运行	自绦
自动撤销	自驮
辅助进制旗标	o助M位旗
辅助文件	o助n案
可用的加载项	可用的增益集
可用按钮	可用的按o
均值	平均值
B 驱	B 磁碟C
网络骨干	W路骨
背景颜色	背景色彩
后备窗口	後湟窗
备份文件	浞n案
回溯兼容性	回溯相容性
带宽	l
条状图	LlD
条码读出器	laxC
基地址	基底位址
基类	基Ae
基线	基示
基本配置	基本MB
基本对象事件	基本物件事件
批量采集	批次X取
批文件	批次n案
波特	U率
最好质量	最好品|
较好质量	^好品|
二元运算符	二元\算子
二分查找	二分搜し
二叉树	二元
二进制	二M位
绑定内容	MY热
绑定器	MY器
绑定	MY
位区域	位元谖
位	位元
位运算符	位元\算子
位图文件	cDn案
位图资源	cDY源
位图	cD
位掩码	位元遮罩
比特率	位元率
逐位复制	逐位元}u
位运算符	位元\算子
逐位	逐位元
列块	^K
登机牌	登CC
书签文字	`文字
书签	`
布尔值	布林值
启动载入程序	虞d入程式
启动载入器	虞d入器
边界	
系结区域	MY谖
有括号的表达式	有括的\算式
断开用户连接	中嗍褂谜哌B
断开点文字	中帱c文字
断开点	中帱c
网桥	蚪悠
公文包	公事包
宽带	l
广播地址	V播位址
断开的链接	中嗟倪BY
网桥路由器	蚪勇酚善
浏览方式	g[方式
浏览按钮组	g[按oM
浏览信息文件	g[Yn案
浏览外观	g[外^
浏览字体	g[字型
浏览器	g[器
协同控件	f同控制
构建信息	M建Y
构建配置	M建MB
构建标签	M建嘶`
构建	M建
内置数据类型	冉ㄙY料型
内置	冉
生成器	a生器
建置列块	建置^K
内置菜单	冉üδ鼙
内置按钮	冉ò粹o
大量复制工具程序	大量}u工具程式
大量数据录区域交换	大量Y料谖唤Q
大量数据录区域交换	大量Y料谖唤Q
大量数据列采集	大量Y料列X取
刻录	
总线	R流排
商务对象	商瘴锛
正忙	忙碌中
按钮常量	按o常
按钮控件	按o控制
按附件	依附件
按附件	依附件
按城市	依城市
按公司	依公司
按日期	依日期
按描述	依描述
按讨论	依
按驱动器名	依磁碟C代
按电邮	依]
按旗标	依旗
按文件夹	依Y料A
按可用空间	依可用空g
按位置	依位置
按信件	依信件
邮件程序	信件w
按名称	依名Q
按昵称	依糠Q
按源位置	依原始位置
按优先	依先
按特性	依特性
按收信	依收信
按寄信人	依寄信人
按发信人	依l信人
按寄信	依寄信
按服务器	依伺服器
按服务	依服
按大小	依大小
按从小到大	依由小而大
按状态	依B
按主题	依主}
打的	搭程
按电话	依
按类型	依型
按未读	依未x
字节数组	位元M列
字节	位元M
C 调用惯例	C 呼叫T例
C 连系规范	C BM
数据包项目节点	封包０腹c
数据包文件生成器	封包n案a生器
数据包	封包
缓存	快取
缓存区	快取^
计算器	小算P
调用栈	呼叫堆B
调用树状图	呼叫D
调用级别介面	呼叫蛹介面
调用运算符	呼叫\算子
调用返回	呼叫返回
回调区域	回呼谖
回调函式 	回呼函式
调用惯例 	呼叫T例
调用外部程序	呼叫外部程序
调用顺序 	呼叫序
摄像机	z影C
候选函数	候x函式
不能访问	o法存取
不能打开	o法_
捕捉文件	X取n案
已采集视频	已X取
插入号 	插入
回车符 	Q行字元
回车符	Q行字元
复位换行组 (CRLF)	臀Q行M (CRLF)
层叠式菜单	盈B式功能表
层叠窗口	重B@示窗
层叠窗口	重B@示
串联 	串
重叠窗口	重B窗
全字匹配	全字拼符合
实例	案例
盒式录音带	卡式音
转型 	D型
Catch 列块	Catch ^K
CD 音频特性	CD 音特性
CD 音频	CD 音
光驱	光碟C
CD-ROM 压制	CD-ROM 貉u
刻录机	器
光盘	光碟
单元格	Υ娓
水平居中	水平置中
屏幕中央	幕中央
垂直居中	垂直置中
居中	置中R
更改图标	更D示
更改国别设置	更eO定
更改端口	更B接埠
更改区域设置	更^域O定
更改方案	更方案
更改脚本	更_本
更改设置数值	更O定值
改变窗口位置	更窗的位置
改变窗口大小	更窗的大小
字符	字元
字符码	字元a
字符常量	字元常
驱动器的字母代号	磁碟C的字母代
字符索引 	字元索引
字符常值 	字元常值
字符位移 	字元位移
字符集 	字元集
字符	字元
文字模式应用程序	文字模式用程式
字符集	字集
字符	字元
复选框	核取方K
检查条件约束 	z查l件s束
勾选标志	勾x擞
验证用户名	z查使用者名Q
复选框	核取方K
已选定	已x取
总和检查码 	和z查a
子程序代码	子程式a
子控件	子控制
子窗口	子窗
汉字	中文字
芯片	晶片
选择类	x耦e
链接选择	x襁B
套索 	套索
列块包装函式 	^K包b函式
列块 	^K
CL 环境变量	CL h境
类标识项 (CLSID)	eRe (CLSID)
类模块	e模M
类查看	ez
类本体	e本w
类浏览器	eg[器
类生成器工具	ea生器工具
类定义	e定x
类声明	e宣告
类继承列表	e衍化清
类工厂	e工S
类文件	en案
类标头	e祟^
类阶层	eA
类标识项 	eRe
类初始设置式 	e初始O定式
类实例	ew
类库 	e
类方法程序 	e方法程序
类范围 	e
类模板偏特化	e模板部份特化
类模板特化	e模板特化
类模板	e模板
类变量 	e
类 	e
初始状态的计算机 	初始B的X
客户端应用程序	客舳用程式
客户端批量数据指标库	客舳伺次Y料指顺淌
客户端验证	客舳苏JC
客户端计算机	客舳穗X
客户端项	客舳隧目
客户端对象	客舳宋锛
客户端站点	客舳苏咎
客户端/服务器	客舳/伺服器
碎片文件	素材n案
裁剪路径 	裁剪路
剪贴板文件格式	剪N簿n案格式
剪贴板拥有人 	剪N簿碛腥
剪贴板查看器	剪N簿z器
剪贴板	剪N簿
剪贴板查看器链 	剪N簿z器
裁剪精确值 	裁剪精_值
裁剪区域 	裁剪^域
裁剪 	裁剪
克隆	仿u
克隆	仿u品
临近工作区 	R近工作^
关闭当前文档	P]F用的文件
结尾标志	Y尾擞
CLS 兼容	CLS 相容
丛集索引 	布索引
代码管理器资源管理器	代a管理器n案管
代码管理器查看器	代a管理器z器
代码撰写设置数值	代a撰O定值
代码查看	代az
代码查看器	代az器
代码窗口文本	代a窗文字
代码窗口	代a窗
代码注解	代]解
代码组件	代a元件
代码库	代a程式
代码管理对象	代a管理物件
代码页	字a
代码后置的文件	代a後置的n案
强制型转 	制型D
摺叠项目 	摺B目
定序 	定序
集合类 	集合e
集合对象 	集合物件
集合对象	集合物件
颜色常量	色彩常
颜色渐层	色彩u
颜色方案	色彩方案
颜色	色彩
数据列标题	Y料祟}
数据列	Y料
区域	谖
组合情景	M合鼍
组合框	M合方K
组合框控件	M合方K控制
命令行的参量	命令行的引
命令行参量的选项	命令行引档倪x
命令文件	命令n案
命令标识项	命令Re
命令消息	命令息
备注文字	]解文字
备注分隔符号	]解分隔符
注释	]解
通用型对话框	通用型υ方K
通用对象文件格式 (COFF)	通用物件n案格式 (COFF)
通用控件	通用控制
通用数据录	通用Y料
通用对话框	通用υ方K
压缩型态的可程序文件	嚎s型B的可绦n案
比较文件	比^n案
比对符	比ψ
比较运算符	比^\算子
兼容的 OLE 伺服程序	相容的 OLE 伺服程式
兼容的对象应用程序	相容的物件用程式
兼容	相容
兼容的	相容的
编译资源文件	gY源n案
终衍对象	K衍物件
复杂命令集计算机 (CISC)	}s命令集X (CISC)
复杂系结	}sMY
兼容	相容
组件展示廊	元件展示廊
组件负载平衡	元件d平衡
组件名称	元件名Q
组件对象模型 (COM)	元件物件模型 (COM)
组件登录器	元件登器
组件服务总管	元件服湛管
组件匣	元件匣
组件向导	元件精`
组件代码生成器	元件程式aa生器
组件对象	元件物件
组件项目	元件０
组件选定器	元件x取器
组件站点	元件站台
组件软件	元件w
组件	元件
复合控件	}合控制
复合视频输入	}合入
复合视频	}合
复合文件文件	}合文件n案
复合文件	}合n案
复合设置运算符	}合O定\算子
计算机辅助翻译	Xo助翻g
计算机名	X名Q
计算机	X
串连运算符	串B\算子
实在的	具象的
同时连接	同rB
条件式编译的参量:	l件式g的引:
条件断开点	l件中帱c
条件表达式	l件\算式
条件表达运算符	l件\算\算子
避孕套	保U套
配置完成	MB完成
配置数据	MBY料
配置数据库	MBY料
配置错误	MBe`
配置文件	MBn案
配置信息	MBY
配置管理器	MB管理器
配置管理器	MB管理器
配置参数	MB
配置设置数值	MBO定值
配置向导	MB精`
配置	MB
配置的	MB的
配置新设备	MB新b置
确认文件夹替换	_J取代Y料A
连接字符串	B接字串
全部连接	全部B
可连接对象	可B接物件
连接上	B上
连接到	B到
正在连接	正在B
连接断开	B切
使用中的连接	使用中的B
链接可能被断开	B已中
连接导向	B向
连接点	Bc
连接共用	B共用
连接字符串	B字串
连接	B
常量	常
常量	常
常量宣告	常敌告
常量表达式	常颠\算式
常量传用	常饔
常量	常
构造函数	建式
谘询	
谘询公司	公司
被收纳的控件	被收{的控制
容器应用程序	容器用程式
容器程序	容器程式
集装箱	
内嵌无效的字符	群o效的字元
内容标识码	热葑Rea
快捷菜单	快@功能表
快显菜单	快@功能表
内容运算符	热葸\算子
内容字符串	热葑执
对比度	Ρ
控件库	控制程式
控件向导	控制精`
控件类	控制e
控件容器	控制容器
控制设备	控制b置
控制标识码	控制Rea
控制面板	控制台
控件项目	控制０
控件特性	控制特性
控件模板	控制模板
控件变量	控制
控件视觉外观	控制X外^
控件	控制
控件工具栏	控制工具列
控件	控制
常规内存	鹘yw
转换宏	DQ巨集
转换对象	DQ物件
复制建构函式	}u建函式
复制磁盘	}u磁碟
复制传用	}u饔
死机	C
创建新文档	建立新的文件
开辟存储区	建立Υ骟w
创建字幕	建立字幕
创建时间	建立日期
十字光标	十字型游
交叉数据表查询	交叉Y料表查
当前的路径	目前的路
当前的设置数值	目前的O定值
当前文档	目前文件
当前图标	目前D示
当前位置	目前位置
当前	目前
光标	游
自定义控件	自控制
自定义介面	自介面
自定义放大	自放大
自定义资源模板	自Y源模板
自定义资源	自Y源
自定义	自
自定义工具箱	自工具箱
自定义	自
自定义类	自e
自定义文件	自文件
循环冗余核对 (CRC)	循h冗N核 (CRC)
数据访问对象 (DAO)	Y料存取物件 (DAO)
数据访问对象 (DAO)	Y料存取物件 (DAO)
数据类	Y料e
数据控件	Y料控制
数据成员	Y料成T
数据对象向导	Y料物件精`
数据报表设计工具	Y料蟊碓O工具
数据源定位器	Y料碓炊ㄎ黄
数据源	Y料碓
数据类型	Y料型
数据查看	Y料z
数据配接器	Y料配接器
数据绑定代理程序	Y料MY代理程式
数据绑定	Y料MY
数据断开点	Y料中帱c
数据命令	Y料命令
数据连接	Y料B接
数据声明	Y料宣告
数据键入页	Y料入
数据区域	Y料谖
数据文件	Y料n案
数据格	Y料格
数据句柄	Y料句柄
数据链接	Y料BY
数据成员字符串	Y料成T字串
数据点	Y料c
数据供应商	Y料提供者
数据传输速度	Y料速率
数据传输率	Y料鬏率
数据区段	Y料^段
数据源名称	Y料碓疵Q
数据源层	Y料碓
数据存放区	Y料存放^
数据流	Y料串流
数据结构	Y料Y
数据符号	Y料符
数据数据表	Y料Y料表
数据传输对象	Y料鬏物件
数据	Y料
数据系结	Y料MY
数据定义查询	Y料定x查
数据库图表	Y料D表
数据库注册向导	Y料煸]跃`
数据库拆分向导	Y料旆指罹`
数据库类	Y料斓燃
数据库表单	Y料毂
数据库管理系统	Y料旃芾硐到y
数据库对象	Y料煳锛
数据库项目	Y料０
数据库角色	Y料旖巧
数据库结构描述	Y料旖Y描述
数据库模板	Y料炷０
数据库用户	Y料焓褂谜
数据库	Y料
数据包套接字	Y料包通端
数据包	Y料包
数据集	Y料集
数据工作表	Y料工作表
日期数据类型	日期Y料型
数据库项目	Y料０
DDE 对谈信息	DDE φY
DDE 链接	DDE BY
DDE 消息	DDE 息
DDE 响应	DDE 回
数据定义语言	Y料定xZ言
无作用程序代码	o作用程式a
无作用保存体	o作用Υ骟w
调试堆积	慑e堆e
调试内存分派器	慑ew分派器
调试监视器	慑eO器
Debug 对象	Debug 物件
调试暂存器	慑e捍嫫
调试终端	慑eK端C
调试版本	慑e版本
调试工具	慑e工具
调试集成	慑e整合
调试事件	慑e事件
调试信息	慑eY
10 进制	10 M位
声明陈述式	宣告述式
声明类型	宣告型
声明	宣告
声明符	宣告子
降序	fp
深层复制配置	深友}uMB
深层复制	深友}u
默认访问权限	AO存取嘞
默认参量	AO引
默认建构函式 	AO建函式
默认杂凑代码供应商	AOs程式a提供者
默认消息处理	AO息理
默认对象处理常式	AO物件理常式
默认安全性	AO安全性
默认值	AO值
默认窗口程序 	AO窗程序
默认	AO
双击的默认	B按上禄鼠的AO
变形项 	形
碎片整理状态	重MB
磁盘清理程序	清理磁碟
开始整理	立即重M
延迟载入 	延td入
延迟渲染	延t演算上色
发送延迟	魉脱俞
委派类型 	委派型
删除查询 	h除查
分隔符号 	分隔符
相依文件 	相依n案
相依文件	相依n案
相依对象 	相依物件
相关项目 	相P０
部署子向导	部署子精`
部署向导	部署精`
解参考算符	解⒖歼\算子
取值运算符	取值\算子
取值 	取值
子类	子e
派生类	衍生e
衍生类 	衍生e
衍生类型 	衍生型
子代窗口	子代窗
降序	fp
描述列块	描述^K
	契s式O
设计模式	O邮
设计时期控件 (DTC)	Or期控制 (DTC)
设计时期对象	Or期物件
设计工具主应用程序	O工具主用程式
台式计算机	桌上型X
桌面窗口	桌面窗
台式机	桌上型
目标语系	目的Z系
接收端应用程序	接收端用程式
目标盘已满	目的地磁碟C已M
目标端标签	目的端嘶`
目标矩形	目的矩形
目标	目的
目标端	目的端
析构	解
析构器	解式
详细信息	Y
详细数据表	Y料表
明细查看	z
检测到	y到
程序开发服务器	程式_l伺服器
控制列块数据 (DCB)	控制^KY料 (DCB)
设备内容	b置热
设备驱动程序	b置映淌
设备管理程序	b置管理器
设备名	b置名Q
设备离线	b置x
设备就绪	b置就w
设备	b置
与设备相关位图	cb置相PcD
与设备无关位图文件	cb置oPcDn案
与设备无关位图	cb置oPcD
与设备无关	cb置oP
设备模式设置	b置模式O定
区号规则	芴t
对话框列	υ方K列
对话数据交换 (DDX)	υY料交Q (DDX)
对话数据验证 (DDV)	υY料C (DDV)
对话框	υ方K
对话框容器	υ方K容器
对话框编辑器	υ方K器
对话框原始文件	υ方K原始n案
对话框模板	υ方K模板
对话框单位 (DLU)	υ方K挝 (DLU)
对话框架构应用程序	υ方K架用程式
对话框程序架构	υ方K程式架
对话框架构	υ方K架
拨号网络适配器	芴W路配接卡
拨接网路连接	芴W路B
拨号服务器	芴伺服器
与设备无关的位图 (DIB)	cb置oP的cD (DIB)
差异合并自定义标志服务	差合阕杂擞服
差异合并编辑器	差合憔器
差异合并 UI 仲介服务	差合 UI 仲介服
差异/合并撤销单位	差/合驮挝
差异/合并	差/合
差异查看器	差z器
不同的项目	不同的０
点限定表达式	c限定\算式
数字相机	滴幌C
数字时钟	滴r
数字	滴
双并词	p阍~
维度 	S度
无效文本	o效文字
二极管	二Ow
直接电缆连接	直接|B
直接访问模式	直接存取模式
指示符	命令
目录列表方块	目清畏K
禁用的文本	停用的文字
反组译码窗口	反Mga窗
全部断开连接	全部中噙B接
断开	中
探索 	探索
讨论服务器	伺服器
断续图形 	嗬mD形
驱动器	磁碟C
磁盘卷标	磁碟嘶`
磁盘	磁碟
分派标识符	分派Rea
分派介面 	分派介面
分派映射	分派τ
分布式	分散式
显示适配器	@示介面卡
显卡	@示卡
显示设备内容	@示b置热
显示文件	@示n案
显示设置数值	@示器O定值
分布式组件对象模型 (DCOM)	分散式元件物件模型 (DCOM)
分布式生成环境 (DCE)	分散式\算h境 (DCE)
分布式管理环境	分散式管理h境
分布式交易协调器 (DTC)	分散式交易f{器 (DTC)
分布式应用程序	分散式用程式
拆分线样式	分割邮
内文列块	任^K
动态链接库 	BBY程式
可停驻工具栏	可停v工具列
停驻窗口	停v窗
停驻工具栏	停v工具列
文档传阅向导	文件鏖精`
文档模板字符串	文件模板字串
文档项目	文件目
文档长度	文件L度
文档菜单	文件功能表
文档名	文件名Q
文档对象	文件物件
文档模板	文件模板
文档窗口	文件窗
文档	文件
文档集合	文件集合
文档特性	文件特性
域管理	W域管理
域名称	W域名Q
域后缀	W域字尾
域	W域
主控件	主控制
不删除	不要h除
不要再显示此对话框	不要再@示此υ方K
点运算符	句c\算子
双字节字符集 (DBCS)	p位元M字元集 (DBCS)
双面水平打印	p面水平列印
双面垂直打印	p面垂直列印
草稿般的打印质量	草稿列印品|
拖放	拖曳
拖放模式	拖曳模式
绘制对象	Lu物件
磁盘栏	磁碟列
驱动器配置	磁碟MB
磁盘	磁碟
磁盘列表方块	磁碟清畏K
驱动程序开发套件 (DDK)	映淌介_l套件 (DDK)
驱动盘	映淌酱牌
驱动器号	磁碟C代
车照	{陶
驱动程序	映淌
置放源	置放碓
下拉式列表	下拉式清
下拉式菜单	下拉式功能表
数据源名称 (DSN)	Y料碓疵Q (DSN)
倾印设备	A印b置
重复文件	重}n案
动态数据交换 (DDE)	BY料交Q (DDE)
动态超文本标志语言 	B超文字擞Z言
动态绑定	BMY
动态创建	B建立
动态数据指标	BY料指
动态链接	BBY
动态链接库	BBY程式
动态分隔窗口	B分隔窗
动态类型信息	B型Y
动态链接库文件	BBY程式n案
动态链接库	BBY程式
动态集类型的数据录集	B集型的Y料集
动态集类型的数据录集	B集型的Y料集
早期绑定	早期MY
编辑项目配置	０附MB
编辑控件	控制
编辑文件	n案
编辑链接	BY
特技	特效
有效地址	有效位址
信件程序	信件w
内嵌对象	惹段锛
清空回收站	清空Y源回收筒
启用单击方式的 URL 巡览	⒂冒匆幌路绞降 URL 巡[
启用状态	⒂B
被封入类	被封入e
	外e
封入类	封入e
封入标志	封入擞
被包括类型	被群型
包括类型	群型
用户授权合约 (EULA)	使用者授嗪霞s (EULA)
文件结尾	n案Y尾
用户	使用者
加强型图元文件	加型中^n案
整个项目	整０
枚举类型	列e型
枚举特性	列e特性
枚举值	列e值
环境变量	h境
终解程序代码	K解程式a
等号运算符	等\算子
均衡器	等化器
抹除软盘	抹除磁片
抹除磁盘	抹除磁碟
清除所选内容	清除所x的
Err 对象	Err 物件
错误性运行	e`性绦
查错	e`z查
错误消息	e`息
错误号	e`代
Error 对象	Error 物件
逸出字符	逸出字元
事件反升	事件反N
事件日志文件	事件日In案
事件映射	事件τ
事件掩码	事件遮罩
事件对象	事件物件
事件注册项	事件]皂
事件响应对象	事件回物件
事件接收映射	事件接收τ
事件源	事件碓
事件就绪对象	事件就w物件
示例页	例
示例	例
异常声明	常宣告
运行栏	绦辛
可程序文件项目	可绦n案０
可运行字节	可绦形辉M
可程序文件	可绦n案
可运行的	可绦械
可程序文件	可绦n案
运行延迟	绦醒舆t
运行字符集	绦凶衷集
运行	绦
程序文件	绦n案
退出并返回	x_後回到
退出代码结束代码	x_代a
退出帮助	x_椭
展开文件夹	展_Y料A
扩展内存	U充w
外显初始设置式	外@初始O定式
外显链接 	外@BY
资源管理器	n案管
导出数据库模板	R出Y料炷０
导出作业	R出作I
导出文件	R出n案
导出函式	R出函式
公开介面 	公_介面
表达式评估	\算式u估
表达式评估工具	\算式u估工具
生成陈述式 	\算述式
表达式	\算式
扩展巴克斯格式 	延伸巴克斯格式
扩展预存程序	延伸A存程序
扩充对象 	U充物件
扩展样式	延伸邮
扩充性供应商 	U充性提供者
扩充项 	U充
可扩展标志语言 (XML)	可延伸擞Z言 (XML)
可扩展样式表语言转换 (XSLT)	可延伸邮奖碚Z言DQ (XSLT)
可扩展样式表语言 (XSL)	可延伸邮奖碚Z言 (XSL)
扩充内存	延伸w
扩展	延伸
外部标识符	外部Rea
外部链接	外部BY
引出操作符 (>>)	引出\算子 (>>)
激活帮助失败	o法活化椭
未能配置	o法MB
不能打开文档	o法_⑽募
快速扫描	快速呙
FAT 文件分派表	FAT n案分派表
首选快程序代码优化 	偏好快程式a最佳化
首选小程序代码优化 	偏好小程式a最佳化
收藏夹	我的最
收藏的	最鄣
区域数据成员	谖毁Y料成T
区域分隔符	谖环指舴
区域类型	谖活型
区域	谖
文件型 DSN 	n案型 DSN
文件传输协议 	n案鬏通f定
FAT 文件分派表	FAT n案分派表
文件关联管理	n案P管理
文件缓冲区	n案n^
文件捕捉	n案X取
文件数目	n案
文件例外状况 	n案例外r
扩展名	副n名
文件句柄	n案句柄
文件输出入 (I/O)	n案出入 (I/O)
文件长度	n案L度
文件列表	n案清
文件锁定	n案i定
文件 Moniker	n案 Moniker
文件指标	n案指
文件特性	n案特性
文件范围 	n案
文件状态 	n案B
文件时间	n案rg
文件跟踪器	n案追器
文件树	n案
文件类型	n案型
文件	n案
文件服务器应用程序	n案伺服器用程式
扩展名	副n名
文件名	n案名Q
两端对齐	填M段落
填满因数 	填M因
胶卷	片
限制复制列	限制}u列
文件中查找	n案中ふ
批量文件查找	多重n案ふ
项目中查找	０钢ふ
查找符号	ふ曳
查找文字	ふ椅淖
查找目标	ふ夷
查找	ふ
细致	@
固件	gw
第一条	第一P
固定工具窗口	固定工具窗
固定的对话框	固定的υ方K
双线的固定对话框	p的固定υ方K
固定长度字符串	固定L度字串
固定字幅 	固定字幅
避免重绘闪动 	避免重LW
浮点数 	浮c
浮动工具栏 	浮庸ぞ吡
浮点数据类型 	浮cY料型
浮点函式 	浮c函式
浮点数值 	浮c抵
软盘	式磁碟C
软盘	碟
软盘	磁碟片
流量控制 	流量控制
刷新	清理
焦点矩形 	焦c矩形
焦点 	焦c
文件夹跟踪器	Y料A追器
文件夹	Y料A
字体文件	字型n案
字体对应器 	字型器
字体资源	字型Y源
字体方案	字型方案
字体查看	字型z
字体	字型
页尾 	尾
前景窗口	前景窗
外部应用程序	外部用程式
外部索引键数据表	外部索引IY料表
表单类	表晤e
表单格线设置数值	表胃窬O定值
表单布局窗口	表尾季忠窗
表单管理对象	表喂芾砦锛
表单查看	表z
表单架构应用程序	表渭用程式
型式参量	型式引
型式参数列表	型式登
格式化磁盘	格式化磁碟
格式字符串	格式字串
格式符	格式子
前置声明	前置宣告
基类	基Ae
框架控件	框架控制
框架窗口	框架窗
框	框
可用字节	可用位元M
可用影像字节	可用影像位元M
剩余图形接口资源	剩ND形介面Y源
剩余内存	剩Nw
剩余空间	剩N空g
剩余系统资源	剩N系yY源
剩余用户资源	剩N使用者Y源
剩余	剩N
周五	L五
文件传输协议 	n案鬏通f定
完全控制组件	完全控制元件
完全 DV 质量	完全 DV 品|
完全链接	完全BY
全模块查看	全模Mz
完整路径名称 	完整路矫Q
全屏方式	全幕模式
全屏	全幕
完整帧	完整面
完全质量采集	完全品|X取
全伺服应用程序	全伺服用程式
全伺服程序 	全伺服程式
全角	全形
完整类名称 	完整e名Q
函式主体 	函式主w
函式调用 	函式呼叫
函式调用计数 	函式呼叫
函式涵盖范围 	函式涵w
函数对象	函式物件
函数重载解决方案	函式多dQh程序
函数多载化 	函式多d化
函数覆盖 	函式覆
函数概况表	函式概r表
函数范围 	函式
函数集	函式集
函数模板	函式模板
函式运行时间 	函式绦rg
函式阶层链接 	函式A舆BY
函式原型范围 	函式原型
功能组	功能群M
功能向导	功能精`
仿函数	仿函式
主要数据类型	主要Y料型
假名备注	假名]解
未来值 	未碇
内存回收行程	w回收行程
网关	通l
网关	l道器
常规性保护错误 (GPF)	一般性保oe` (GPF)
常规	一般
常规用途	一般用途
生成器	a生器
通用类设置	通用eO定
泛用创建者	通用建立者
通用算法	通用演算法
全域默认	全域AO值
全域对象	全域物件
全域优化	全域最佳化
全域变量	全域
图形缓存	D形快取
良好质量	良好品|
转到	前往
抓取视频帧	抓取
等级名	等名Q
图形对象	D形物件
图形用户介面GUI	D形使用者介面GUI
图形设备介面 (GDI)	D形b置介面 (GDI)
变灰的菜单项	灰的功能表目
灰度	灰A
方格控件	方格控制
组依据	群M依
组列表	群M清
组成员	群M成T
群组重命名	群M重新命名
组方块控件	群M方K控制
程序代码保护区间	程式a保o^g
图形用户介面 (GUI)	D形使用者介面 (GUI)
海湾	波斯
黑客	客
硬件已经禁用	硬w已停用
半角	半形
处理函数	理常式
交握协议	交握f定
全角韩文	全形n文
硬盘驱动器	硬碟C
硬盘	硬碟
硬件	硬w
汉姆雷特	哈姆雷特
散算法	s演算法
散多重集	s多重集
散数	s
散列表	s表
散值	s值
标头控件	祟^控制
标头文件	祟^n案
前置数据	前置Y料
帮助文件	椭n案
帮助文件	椭n案
帮助映射文件	椭τn案
帮助项目文件	椭０n案
帮助查找程序	椭搜こ淌
帮助选择	x椭
Helper 对象	Helper 物件
16 进制倾印	16 M位A印
十六进制	十六M位
16 进制	16 M位
HHCtrl 对象	HHCtrl 物件
高档	高
层次体系	A芋w系
高位	高位元
高端	高A
高亮显示文字	高亮度@示文字
高亮	高亮度
高亮显示	高亮度@示
历史	v史
点击测试代码	cy程式a
主页	首
水平平铺	水平K排
水平滚动条	水平暂S
主应用程序	主用程式
装载控件	bd控制
装载信息	bdY
主机名	主X名Q
热键	快速I
沙漏光标	沙漏游
如何使用帮助	如何使用f明
HTML 布局文件	HTML 布局n案
HTTP 服务器	HTTP 伺服器
超文字传输协议 (HTTP)	超文字鬏通f定 (HTTP)
超链接地址	超BY位址
超链接基底	超BY基底
超链接	超BY
超文字标志语言 (HTML)	超文字擞Z言 (HTML)
超文字传输协议 (HTTP)	超文字鬏f定 (HTTP)
超文字链接	超文字BY
图标栏	D示列
图标文件	D示n案
图标资源	D示Y源
图标	D示
集成开发环境 	整合_lh境
标识符文字	Re文字
标识码前置词	Rea前置~
未指定类型的标识项	未指定型的Re
标识符	Re
标识代码	Rea
标识	Re
标识值增量	Re值增量
标识分割	Re分割
标识值种子	Re值N子
空闲感应器	f置感器
空闲状态	f置B
空闲时间	f置rg
空闲	f置
IIS 应用程序根目录	IIS 用程式根目
图象文件	D像n案
影像列表	影像清
图象映射	D像τ
IME 组字窗口	IME M字窗
键入法	入法
即时生成窗口	即r\算窗
直接参量	直接引
立即渲染	立即演算上色
实现介面向导	作介面精`
实现介面	作介面
实现	作
由实现环境决定	由作h境Q定
实现介面	作介面
实现器	作器
实现项	作
隐含链接	[含BY
隐式	[喻的、暗自的、[式
导入数据库模板	R入Y料炷０
导入文件	R入n案
导入函式	R入函式
In-Memory 文件	In-Memory n案
就地激活	就地活化
就地激活	就地活化
同进程组件	同M程元件
同进程调试	同M程慑e
同进程服务器	同M程伺服器
非活动	非作用中
英寸	英
Inlcude 文件	Inlcude n案
包含子文件夹	包含子Y料A
升序操作符 (++)	f增\算子 (++)
增加运算符	累加\算子
累加查找:	累加搜:
累加编译版	累加建置
累加链接	累加BY
累加链接器	累加BY器
累加状态文件	累加Bn案
独立软件厂商 (ISV)	立wS商 (ISV)
索引循序访问方法 (ISAM)	索引循序存取方法 (ISAM)
帮助主题	f明索引
索引查看	索引z
索引符传回类型	索引子骰仡型
索引符	索引子
间接内存编址生成元	g接w定址\算元
间接取值操作符 (*)	g接取值\算子 (*)
无限递回	o限f
无穷大	o限大
中置标志法	中置擞法
信息	Y
信息内容	Y热
信息流程	Y流程
信息模型	Y模型
信息	Y
初始化文件	初始化n案
初始设置式	初始O定式
内联汇编语言	行冉M合Z言
内联组译程序代码	行冉Mg程式a
内联展开	行日归_
内联文件	行n案
内联函式	行群式
内联脚本	行饶_本
内联样式	行邮
内联	行
内部类	炔款e
键入焦点	入焦c
键入法 (IME)	入法 (IME)
键入源	入碓
插入文件	插入n案
可插入的对象	可插入的物件
引入操作符 (<<)	引入\算子 (<<)
安装/删除	安b/移除
正在安装离线复制	正在安bx}u
实例句柄	w句柄
实例方法	w方法
实例变量	w
实例	w
实例模型	w模型
实例控件	w控制
具现样板	w影
实例化	w化
实例化	w化
命令计划	命令排程
整数类数据类型	整殿Y料型
整体服务数位网络 (ISDN)	整w服滴痪W路 (ISDN)
集成式开发环境	整合式_lh境
互动用户	互邮褂谜
交互式	交式
连接架构	互相B方案
介面标识项 (IID)	介面Re (IID)
介面文件	介面n案
介面标识码	介面Rea
集成电路	ew路
内景颜色	染吧彩
内部链接	炔窟BY
国际设置数值	HO定值
互联网控制消息协议	WHW路控制息通f定
互联网工程任务推动小组	WHW路工程任胀有〗M
Internet 协议	Internet 通f定
多人在线交谈系统 (IRC)	多人上交系y (IRC)
Internet 服务器应用程序发展介面 (ISAPI)	Internet 伺服器用程式l展介面 (ISAPI)
Internet 服务器扩充 DLL	Internet 伺服器U充 DLL
Internet 服务器扩充功能	Internet 伺服器U充功能
Internet 服务器过滤常式	Internet 伺服器Yx常式
互联网	WHW路
互联网	WHW路
互通性 	互通性
中断	插
线程交互封送 	程交互封送
内置常量	冉ǔ
内置控件	冉控制
内置函式 	冉ê式
字符无效	o效字元
非法文件名	n名o效
非法文件名	n案名Qo效
不变量表达式 	不量\算式
IP 地址	IP 位址
ISAPI 扩充程序向导 	ISAPI U充程式精`
隔离保存区	隔xΥ^
隔离保存体	隔xΥ骟w
问题详细数据表单	}Y料表
发行人	l照者
问题列表	}清
意大利	x大利
项目副文件名	目副n名
项目文件名	目n案名Q
迭代	迭代
迭代	迭代
迭代的	迭代的
迭代器	迭代器
不规则数组	不t列
合并回圈	合戕圈
JIT 调试	JIT 慑e
联结运算符	Y\算子
游戏杆	uU
联合数据表	合Y料表
半角片假名	半形片假名
金钥组 	金M
键入	入
机码设置	CaO定
关键值 	PI值
键盘语言及布局	IPZ系及布局
键盘布局文件	IP布局n案
标签磁盘	嘶`磁碟
标志陈述式 	擞述式
花边	蕾z
横向	M印
语言标识码	Z言Rea
大图标	大D示
大规模集成电路	大型ew路
激光唱机	雷射唱C
激光	雷射
最后一条	最後一P
晚期系结	晚期MY
晚期绑定	晚期MY
层次窗口功能	哟我窗功能
布局文件	布局n案
内存布局	w布局
前导字节	前位元M
前置字符为零	前置字元榱
最小显著性字节	最小@著性位元M
左对齐	靠左R
鼠标左键	滑鼠左I
左外部联结 	左外部Y
版权	著作
级别	蛹
语汇分析器 	Z》治銎
语汇分析 	Z》治
语汇范围 	Z」
库文件	程式n案
库版本	程式彀姹
库	程式
自述文件	授fh
免付费之授权 ActiveX 控件	免付M之授 ActiveX 控制
使用权属于	授嘟o
授权机制 	授C制
轻量控件	p量控制
轻量型远程程序调用 	p量型h端程序呼叫
程序行计数 	程式行
程序行涵盖范围	程式行涵w
行尾退出符号	行尾Y束符
程序概况表	程式概r表
行	M列
行接续字符	行接m字元
回车符	Q行字元
链接文件	BYn案
链接时产生代码	BYra生程式a
链接图表	BYD表
链接格式	BY格式
链接对象	BY物件
链接源	BY碓
链接时间	BYrg
链接	BY
连系规格	BM格
链接数据表管理器	BYY料表管理器
链接项目	BY目
链接串列	BY串列
链接化对象	BY化物件
链接样式工作表	BY邮焦ぷ鞅
链接窗口框架	BY窗框架
链接窗口	BY窗
链接器	BY器
链接与嵌入	BYc嵌入
链接库	BY程式
帮助主题列表	列出f明主}
列表查看控件	清z控制
列表	清
列表方块控件	清畏K控制
列表索引	清嗡饕
接听模式	取模式
接听应用程序	接用程式
帮助主题列表	列出f明主}
载入有效地址命令	d入有效位址命令
载入图标	d入D示
启动时载入	rd入
载入调色板	d入{色P
本机 Web 应用程序	本C Web 用程式
本机 Web 服务器	本C Web 伺服器
区域类	^域e
本机文件	本Cn案
局域网	^域W路
本机计算机	本CX
区域对象	^域物件
本地端口	本CB接埠
本机项目	本C０
本机远程程序调用	本Ch端程序呼叫
本机服务器	本C伺服器
区域变量	^域
局部的	^域性的
地区设置标识码	地^O定Rea
地区设置	地^O定
地区设置特性	地^O定特性
地区设置标识码 (LocaleID)	地^O定Rea (LocaleID)
本地化文件	本地化n案
本机的缓存资源	本C的快取Y源
区域变量	^域
位置信息	位置Y
锁定控件	i定控制
锁定项目	i定０
锁定信息文件	i定Yn案
锁定冲突	i定`
日志文件查看器	日In案z器
日志文件	日In案
日志文件	日In案
逻辑等价 	等r
逻辑字体 	字型
逻辑隐含式 	[含式
逻辑程序叙述行 	程式⑹鲂
逻辑运算符 	\算子
逻辑移位 	移位
逻辑单位 	挝
逻辑查看 	z
登录	登入
注销	登出
长文件名	Ln名
长整数 	L整
长指标 	L指
长变量 	L
长整数 	L整
外观浏览器	外^g[器
查看数据表	查Y料表
回圈结构型式	圈Y型式
回圈生成外提	圈\算外提
回圈合并	圈合
回圈优化	圈最佳化
回圈	圈
松开	_
低端	低A
机器数据源名称	C器Y料碓疵Q
麦金塔资源编译器 	金塔Y源g器
麦金塔二进制资源文件 	金塔二M位Y源n案
宏管理器	巨集管
宏定义	巨集定x
宏展开 	巨集展_
宏	巨集
宏对话框	巨集υ方K
邮件	信件
MailItem 对象	MailItem 物件
邮件匣	信件匣
主数据表选定对话框	主Y料表x取υ方K
主应用程序窗口	主用程式窗
主机控制器	主控制卡
主框架窗口 	主框架窗
主存	主w
主消息回圈	主息圈
主渠道	主要途
主数据表 	主Y料表
主机	主X
维护公用程序	So公用程式
制做增益功能	u做增益功能
设置成相同高度	O定成相同高度
设置成相同水平间距	O定成相同水平g距
制做相同大小	u做相同大小
制做数据表查询 	u做Y料表查
制做数据表 	u做Y料表
制做电影	u做影
制作开机磁盘	u作_C磁碟
Makefile 项目向导	Makefile ０妇`
普通话	Z
明示常量	明示常
手动配置	手咏MB
手工	手
制造商	u造S商
制造商	u造商
映射文件	n案
映射网络驱动器	W路磁碟C
映射网络驱动器	W路磁碟C
映射网络资源	W路Y
映射网络	W路
对应文件	n案
映射	τ
标志的	擞的
数据标志	Y料擞
跑马灯控件	跑R艨刂祈
掩码位图	遮罩cD
掩码工作区	遮罩工作^
掩码	遮罩
格式编辑控件	格式控制
格式编辑控件	格式控制
大型存放设备	大型存放b置
子字符串须相符	子字串相符
将窗口放大到实际尺寸	⒁窗放到最大
最大化	放到最大
最大化窗口	最大化窗
最大空间	容量上限
成员访问运算符	成T存取\算子
成员存取运算符	成T取用\算子
成员函数	成T函式
成员初始值列表	成T初始值清
成员变量	成T
成员访问控制	成T存取控制
成员逐一复制	成T逐一}u
内存分派	w分派
内存列块	w^K
内存缓存基底对象	w快取基底物件
内存设备内容	wb置热
内存不够	o足虻挠w
内存布局	w布局
内存遗漏	wz漏
内存模型	w模型
内存对象	w物件
内存使用增量	w使用量差
内存	w
菜单栏	功能表列
菜单控件	功能表控制
菜单项	功能表目
菜单程序	功能表程式集
菜单资源	功能表Y源
菜单	功能表
菜单项标识码	功能表目Rea
消息方块	息方K
消息断开点	息中帱c
消息萃取器	息萃取器
消息文件	息n案
消息过滤器	息^V器
消息处理常式	息理常式
消息处理	息理
消息回圈	息圈
消息映射	息τ
消息封装	息封b
消息帮浦	息推
消息队列	息辛
消息队列	息辛
消息反映	息反映
消息接收	息接收
消息	息
消息驱动	息
消息处理函式	息理函式
消息映射项	息τ稠
消息映射宏	息τ尘藜
信息应用程序发展介面 (MAPI)	息用程式l展介面 (MAPI)
中继标志	中^擞
中继数据	中^Y料
图元文件	中^n案
计量表控件	量表控制
用法	使用方式
度量信息	度量Y
微机	微X
鼠标中间键	滑鼠中gI
中端	中A
转换向导	DQ精`
毫米	公
最小化所有窗口	所有窗s到最小
启动时最小化	rs到最小
最小化	s到最小
最小化窗口	最小化窗
助记符	助符
强制响应	制回
非强制响应表单	非制回表
非强制响应 	非制回
	塑模Z言，建模Z言
建模工具	塑模工具
调制解调器连接	CB
调制解调器	C
模块	模M
模块定义文件	模M定xn案
模块层次	模M哟
周一	L一
等宽字体	等字型
月历控件	月芽刂祈
最大显著性字节	最大@著性位元M
最底层的派生类	最末友苌e
鼠标捕捉	滑鼠捕捉
鼠标事件	滑鼠事件
鼠标信息	滑鼠息
鼠标指标信息告知	滑鼠指擞息告知
鼠标	滑鼠
文件移动	移n案
文件夹移动	移淤Y料A
电影文件	影n案
多重程序代码导入/导出	多重程式aR入/R出
多重链接的链结	多重BY的Y
多用户环境	多使用者h境
多重卷标压缩	多重卷嚎s
多字节字符集 (MBCS)	多位元M字元集 (MBCS)
多字节代码页	多位元M字a
多点发送	多c魉
多行编辑控件	多行控制
多重映射	多重τ
多媒体控件	多媒w控制
多重配置	多重MB
多重文件数据类型	多重文件Y料型
多重文件	多重n案
多重选定	多重x取
多行编辑控件	多行控制
多重选择列表方块	多重x袂畏K
乘法类运算符	乘法\算子
多用途互联网邮件扩展标准 (MIME)	多用途WHW路]件延伸 (MIME)
多线程应用程序	多程用程式
多用户	多使用者
多重查看	多重z
Mutex 对象	Mutex 物件
我的文档	我的文件
收藏夹	我的最
我的项目	我的０
具名参量	具名引
命名的书签	命名的`
命名空间干扰	命名空g干_
窄带	窄l
美国国家超级计算机应用中心 (NSCA)	美家超X用中心 (NSCA)
国家语言支持	家Z言支援
原生数据	原生Y料
嵌套法	巢
嵌套类	巢铑e
嵌套框架	巢羁蚣
嵌套类型	巢铑型
嵌套	巢
嵌套层次	巢哟
网络负载平衡 	W路d平衡
网卡	W路卡
网络地址转译	W路位址Dg
网卡	W路卡
网络连接	W路B
网上邻居	W路上的芳
网络服务供应商 	W路服展商
网络	W路
网络组件	W路元件
从不	永h不
新建超然的工具栏	新增超然的工具列
新盘	新的磁片
新建项目	新增目
新文件夹	新Y料A
新建水平选项卡组	新增水平索引嘶`群M
新建索引键	新增索引I
新建宏命令	新增巨集命令
新邮件	新信件
新密码	新的密a
新建项目	新增０
新搜索	重新搜
新建工具栏	新增工具列
开新窗口	_新窗
新窗口	新增窗
新建(&N)	新增(&N)
新建	新增
新建	新增
NewData 参量	NewData 引
新行字符	新行字元
新行 	新行
下一条	下一P
下一曲目	下一曲目
未选定	]有x
No-Access 字节	No-Access 位元M
非字符串	非字串
非软盘文件	非磁片n案
非内置 OLE	非冉 OLE
非内置 	非冉
非强制响应表单	非制回表
隐藏式 	[藏式
非汇总对象	非】物件
非工作区 	非工作^
非整数类表达式 	非整殿\算式
未分页集区字节	未分集^位元M
非数值类值 	非抵殿值
非静态成员函数 	非oB成T函式
非静态变量	非oB
非系统键 	非系yI
正常拖放	释弦
正常性运行	正常性绦
正常初始化	正_起始
正常选定	蔬x取
常规窗口	室窗
常规	一般
不可用	o法使用
未找到	找不到
笔记本电脑	P型X
告知信息	告知息
以 Nul 退出的字符串	以 Nul Y束的字串
Null 字符	Null 字元
Null 字符串	Null 字串
Null 终端字符字符串	Null K端字元字串
打印数量	列印盗
数值表达式	抵颠\算式
整型参数	整
数字体别	底诸型
对象浏览器筛选条件	物件g[器Yxl件
对象浏览器无过滤条件	物件g[器oYxl件
对象浏览器	物件g[器
对象链接与嵌入 (OLE)	物件BYc嵌入 (OLE)
对象模型	物件模型
目标模块格式	目的模M格式
对象类型	物件型
对象查看器	物件z器
基于对象	基於物件
目标码	目的a
对象描述语言文件	物件描述Z言n案
对象表达式	物件\算式
目标文件	目的n案
对象阶层架构	物件A蛹
目标库文件	目的程式n案
对象库	物件程式
对象映射	物件τ
对象模型	物件模型
对象模块	物件模M
面向对象	物件向
对象集区	物件集^
对象限定词	物件限定~
对象状态	物件B
对象变量	物件
对象的操作	物件的幼
对象	物件
对象导向设计	物件向O
八进制的	八M位的
ODBC 数据指标库	ODBC Y料指顺淌
ODBC 驱动程序	ODBC 映淌
ODBC 	ODBC
OEM 字符集	OEM 字元集
写字楼	k公室
离线发行向导	xl行精`
离线复制	x}u
OLE Automation 控制程序	OLE Automation 控制程式
OLE Automation 对象	OLE Automation 物件
OLE Automation 伺服程序	OLE Automation 伺服程式
OLE DB 供应商	OLE DB 提供者
OLE 伺服程序	OLE 伺服程式
OLE 容器控件	OLE 容器控制
OLE 拖放操作	OLE 拖放幼
在线	上
软键盘	幕小IP
仅	只有
对象导向程序设计 	物件向程式O
开放式数据库连接 (ODBC)	_放式Y料爝B (ODBC)
独占打开权限	组_嘞
开放式信息模型	_放式Y模型
打开链接文件	_⑦BYn案
从 Web 打开项目	 Web _０
打开项目	_０
开放服务架构 	_放服占
开放模式软件说明 (OSD)	_放模式wf明 (OSD)
开放软件基金会 (OSF)	_放w基金 (OSF)
打开方式	_⒎绞
从原始文件控制打开	脑始n案控制_
从 Web 服务器打开	 Web 伺服器_
打开项目	_０
打开所选项目	_⑺x的目
打开这份文档	_⑦@文件
打开(&O)	_(&O)
开头标志	_^擞
生成元	\算元
操作数	\算元
运算码	操作a
操作失败	作I失
操作系统	作I系y
操作	作I
运算符优先顺序	\算子先序
运算符	\算子
优化	最佳化
优化	最佳化
优化中继语言	最佳化中^Z言
优化提示	最佳化提示
选择性参量	x裥砸
或者	或是
序列号	序
原设置	原始O定
原位置	原始位置
其他文件	其他n案
其他信息	其他Y
其他	其它
内存不足	w不足
内存不足例外状况	w不足例外r
跨进程组件	跨M程元件
跨进程调试	跨M程慑e
输出流式	出串流
负担	~外
层叠窗口	重B@示窗
重载解析	多d解析
重载的函数	多d化函式
被重载的运算符	多d化\算子
重载集合	多d集合
重载	多d
强制替代项	制覆
附属窗口	附僖窗
主控窗口	主控窗
主控描绘控件	主控描L控制
封装暨部署向导	封b暨部署精`
软件包	套bw
封装向导	封b精`
封装的 IP 地址	封b的 IP 位址
互联网数据包探索 (PING)	WHW路封包探索 (PING)
数据包集成	封包整合
分组交换	封包交Q
数据包	封包
分页文件字节	分n案位元M
分页错误增量	分e`差
页面设置	面O定
ＢＰ机	呼叫器
色盘映射	色Pτ
卡纸	A
并行	平行
并口	K列
参数数组	店列
参数列块	^K
参数数据成员	蒂Y料成T
参数前置字符	登爸米衷
参数设置	翟O定
参数后置字符	滇嶂米衷
父类	父e
上层菜单	上庸δ鼙
上层对象	上游锛
上层数据表	上淤Y料表
上层窗口	上右窗
父-子关系	父-子PS
剖析映射	剖析τ
传地址	髦
传地址	髦
密码验证协议	密aCf定
密码表	密a清
密码不匹配	密a不符
选择性粘贴	x裥再N上
粘贴链接	N上BY
选择性粘贴	x裥再N上
路径太深	路教L
模式比对字符串	模式比ψ执
模式	邮
峰值分页文件字节	峰值分n案位元M
峰值虚拟字节	峰值M位元M
Peephole 优化	Peephole 最佳化
对等网络	Φ染W路
性能监视器	效能O器
性能	效能
周期	L期
周边组件连接 (PCI)	周元件B接 (PCI)
外围设备	LO
外围	L
永久保存区	永久Υ^
宽松类型语意	型Z意
永续性保存体	永m性Υ骟w
个人证书	人JCY料
个人文件	人n案
物理地址	w位址
实体设备	wb置
实体字体	w字型
物理内存	ww
选定网址	x取W址
图片方块控件	D片方K控制
枢纽分析查看	屑~分析z
象素	像素
文本	文字
播放列表	播放清
即插即用	S插即用
插件	外斐淌
口袋书	袖珍本
点对点协议 (PPP)	cc通f定 (PPP)
指针速度	指怂俣
数据成员指标	Y料成T指
数据指标	Y料指
指针轨迹	指塑E
指针	指
公安	警察
多型 	多型
多态	多型
快捷菜单	快@功能表
快显窗口 	快@窗
填入 	填入
端口名	B接埠名Q
端口号	B接埠a
端口	B接埠
可移植的程序代码 	可移植的程式a
纵向	直印
发布信息	l延息
构建后	建置後
事后剖析调试	事後剖析慑e
后编码 	後a
后置标志法 	後置擞法
潜质	力
节能方式	省模式
节能	s能源
高级用户 	MA使用者
构建前	建置前
链接前	BY前
先行编译标头文件	先行g祟^n案
预先组成的字符	A先M成的字元
预先定义宏	A先定x巨集
首选设备	偏好b置
首选	偏好
前置字符	前置字元
前置标志法 	前置擞法
前置处理器指示词 	前置理器指示~
前置处理器指示词 	前置理器指示~
预处理器	前理器
前置处理器 	前置理器
展示缓存 	展示快取
展示数据 	展示Y料
展示文件	展示n案
简报对象	笪锛
预先设置	A先O定
上一条	上一P
上一曲目	上一曲目
主操作	主幼
打印跨页	列印跨
打印管理器	列印管理器
打印处理器	列印理器
打印缩放	列印s放
打印后台打印器介面	列印多工n理器介面
打印当前文档	列印F用的文件
打印到文件	列印到n案
打印区	列印^
打印	列印
打印机名	印表C名Q
打印机	印表C
打印文件	列印n案
打印作业	列印工作
正在打印	列印中
打印成品	列印成品
优先级	先等
隐私权政策	[私嘣t
私用控件	私用控制
私用堆积 	私用堆e
私有数据包	封包Ｓ
私用变量	私用
程序标识码	程序Rea
程序词汇 	程序~
程序查看	程序z
过程	程序
进程实例	M程w
产品标识码	a品Rea
产品金钥	a品金
产品名称	a品名Q
实际运行数据库	H绦匈Y料
实际运行服务器	H绦兴欧器
产能组件	a能元件
产能工具	a能工具
规划文件	n案
程序数据库文件	程式Y料n案
程序文件	程式n案
程序流程	程式流程
程序组	程式群M
程序标识	程式Re
程序管理器	程式管理器
程序名	程式名Q
程序	程式
可程序化	可程式化
程序设计标识码	程式ORea
程序员	程式T
程序设计环境	程式Oh境
程序撰写模型	程式撰模型
编程	程式O
编程	程式
程序	程式
程序	程式集
进度条控件	M度列控制
进度条	M度列
进度条	M度列
高级选项	MAx
项目相依性	０赶嘁佬
项目目录	０改夸
项目总管	０缚管
项目文件名	０n案名Q
项目位置:	０肝恢:
项目特性	０柑匦
项目窗口	０敢窗
项目及组件管理对象	０讣霸件管理物件
方案文件	０n案
项目信息	０赣息
项目名称	０该Q
项目	０
投影仪	投影C
初构程序代码	初程式a
初构/终解程序代码顺序	初/K解程式a序
提示字符串	提示字串
特性列表	特性清
特性窗口	特性窗
特性浏览器	特性g[器
特性页向导	特性精`
特性数组索引	特性列索引
特性数组	特性列
特性集 	特性集
特性工作表 	特性工作表
协议家族	f定家族
协议处理常式	f定理常式
协议	f定
供应商对象 	提供者物件
供应商 	提供者
代理服务器	代理伺服器
代理服务器	代理伺服器
伪码	假a
虚拟数据行 	MY料行
虚拟封送处理 	M封送理
虚拟代码	M程式a
虚拟目标 	M目
公用列举类型 	公用列e型
公用文件夹	公用Y料A
公开金钥 	公_金
公用控件	公用控制
公用对象	公用物件
在线公共论坛	上公共
公交	公共交通
公用用户	公用使用者
发行物数据表过滤条件	l行物Y料表^Vl件
出版物	出版品
发行者 	l行者
脉冲式电话	鼙P式
标点符号 	它c符
纯虚拟函式 	M函式
限定修饰	Y格修
限定修饰词	Y格修~
质量确定测试套件	品|_定y套件
质量管理	品|管制
质量	品|
查询数值	查值
待发传真	外送髡
队列名	辛忻Q
快速运行	快速绦
快速查看	快速z
引号标识项	引Re
引用级	引言蛹
选项框	芜x按o
单选框	芜x按o
RAM 盘	RAM 磁碟
随机访问内存 (RAM)	SC存取w (RAM)
随机顺序	SCx曲
乱数生成器	y诞a生器
快速应用程序开发 (RAD)	快速用程式_l (RAD)
点阵字体	c字型
光栅作业程序代码	光抛I程式a
未经处理数据	未理Y料
常规介面指标	一般介面指
远程数据对象 (RDO)	h端Y料物件 (RDO)
只读	唯x
只读文件	唯xn案
只读	唯x
自述文件	x我n案
只读	唯x
实模式	真模式
原因未知	原因不
最近的文件	最近的n案
最近使用的列表	最近使用的清
识别的	辨R的
标识组件	Re元件
数据录分隔符号	Y料分隔符
数据录区域交换	Y料谖唤Q
数据录查看	Y料z
录制画外音	u旁白
数据录级别	Y料蛹
录制器	u器
Recordset 对象	Recordset 物件
数据录集对象	Y料集物件
数据录集	Y料集
数据录集类型	Y料集型
矩形数组	矩形列
递回	f
递回地	f地
回收站	Y源回收筒
重定向模式	重新向方案
重定向脚本	重新向_本
将窗口缩为图标	⒁窗s成D示
精简命令集计算机 (RISC)	精命令集X (RISC)
冗余	冗N
参考引用	⒄沾
参考引用	⒄沼
数据引用	⒄召Y料
可参考的程序文件	可⒖嫉绦n案
跟踪引用	⒄兆粉
引用	⒄
引用项目	⒄枕目
引用页	⒄枕
精链	精
暂存器保存类	捍嫫Υ骖e
暂存器变量	捍嫫髯
注册事件	]允录
注册位置	]晕恢
已注册的	已]缘
登录一个工作流程应用程序	登一工作流程用程式
暂存器窗口	捍嫫饕窗
注册器脚本	]云髂_本
注册脚本	]阅_本
系统注册数据库	系y]再Y料
注册登录文件	]缘卿n案
注册金  	]越痄
注册应用程序	]用程式
注册表设置数值管理	]员碓O定值管理
注册数据库	]再Y料
注册表编辑	]员砭
注册表错误	]员礤e`
注册表项	]员眄目
注册表	]员
规则表达式对象	t\算式物件
正则表达式	正\算式
关联式数据库	P式Y料
关系运算符	PS\算子
相对链接	相BY
发行的编译版	l行的M建
重新配置信息	重新配置Y
剩余	剩下
远程访问服务 (RAS)	h端存取服 (RAS)
远程数据控件 (RDC)	h端Y料控制 (RDC)
远程数据对象 (RDO)	h端Y料物件 (RDO)
远程数据服务 (RDS)	h端Y料服 (RDS)
远程调试监视器	h端慑eO器
远程程序调用 (RPC)	h端程序呼叫 (RPC)
远程计算机	h端X
远程连接	h端B
远程调试	h端慑e
远程磁盘	h端磁碟
远程机器	h端C器
远程管理	h端管理
遥感技术	by技g
远程伺服程序	h端伺服程式
远程	h端
移除文件	移除n案
移除程序	移除程式
可移动磁盘	抽取式磁碟
重命名	重新命名
正在渲染音频	正在演算上色音
正在渲染	正在演算上色
重复上次操作	重}上次的幼
全部替换	全部取代
批量文件替换	多重n案取代
文件中替换	n案中取代
项目中替换	０钢腥〈
复制管理器	}u管理器
限制复制准则	限制}ut
全部回覆	回o全部
保存机制浏览器	ΥC制g[器
保存机制引擎	ΥC制引擎
复制生产	}u生a
解析运算符	Qh\算子
解析过程	Qh程序
分辨率	解析度
资源查看	Y源z
资源浏览窗口	Y源g[窗
资源文件	Y源n案
资源标识码	Y源Rea
资源定义文件	Y源定xn案
Response 参量	Response 引
响应文件	回n案
响应	回
计算机重新启动	X重新
将窗口恢复到正常大小	⒁窗回存成实拇笮
还原窗口	回存窗
保留功能在启动状态	保留功能在B
取回文件	取回n案
返回值	骰刂
返回	骰
反向累加查找	反向累加搜
倒放扫描	倒放呙
Rich Edit 控件	Rich Edit 控制
Rich Edit 查看	Rich Edit z
RTF 文件	RTF n案
右对齐	靠右R
鼠标右键	滑鼠右I
右手习惯	T用右手
滚动	
回滚缓冲区	回跃n^
回滚操作	回幼
根对象	根物件
根证书	主要JC
根保存对象	根Υ嫖锛
往返保存区	往返Υ^
往返流式	往返Y料流
路径设置	路皆O定
数据行指标	Y料M列指
行	M列
列级别安全性	列蛹安全性
数据列最小高度	Y料列最小高度
数据列集扩展	Y料列集U展
数据列集	Y料列集
运行时期 DLL	绦r期 DLL
运行 TemporaryMacro	绦 TemporaryMacro
内存用完	w用完
运行时期	绦r期
运行时期库参考手册	绦r期程式⒖际
仅限运行阶段	H限绦须A段
运行时期库	绦r期程式
运行时期行为	绦r期行
运行时期类信息	绦r期eY
运行时期错误	绦r期e`
运行时期实例	绦r期w
运行时期对象	绦r期物件
运行时期属性	绦r期热
运行时期类型信息 (RTTI)	绦r期型Y (RTTI)
运行时期	绦r期
运行对象表格 	绦形锛表格
运行状态	绦B
运行	绦
运行中	绦兄
运行时检查	绦rz查
运行时类型信息 	绦r型Y
运行时	绦r
可用年限退出后的价值	可用年限Y束後的r值
重名	同名
同一窗口	相同窗
示例	例
采样频率 	取宇l率
采样	取
饱合度	舛
周六	L六
文件另存为	n案另存
将文件保存到 Web	n案Υ娴 Web
保存文件	Υn案
保存选定项目	Υ孢x取目
将副本存为	另存浞
保存文档	Υ嫖募
另存文件类型	存n型
保存文件	Υn案
项目另存为	０噶泶
保存项目	Υ０
保存方案	Υ娣桨
保存当前文档	Υ孀饔弥形募
保存此项目	Υ娲０
以编码方式保存	以a方式Υ
保存	Υ
数值类字体	抵殿字型
扫描线 	呙杈
扫描仪	呙槠
散布组件 	散呀M件
实例	案例
情景检测	鼍y
情景	鼍
计划	排程
已计划	已排程
结构描述词汇 	Y描述~
结构描述编号 	Y描述
结构描述数据列集	Y描述Y料列集
科技园	科W@^
生存空间运算符	生存空g\算子
屏幕助读员	幕助xT
屏幕座标	幕座
屏幕	幕
Scribble 应用程序	Scribble 用程式
脚本文件	_本n案
脚本装载支持	_本bd支援
脚本对象模型 (SOM)	_本物件模型 (SOM)
脚本对象	_本物件
向下滚动	向下
向上滚动	向上
滚动条	暂S
滚动块	臃K
滚动条码	暂Sa
滚动条控件	暂S控制
滚动条	暂S
滚动范围	庸
滚动	
SCSI 配置	SCSI MB
查找条件	搜l件
查找准则	搜t
搜索顺序	搜ろ序
查找结果	搜そY果
查找目标	ふ夷
向上查找	向上搜
查找	搜
次要相依信息	次要相依Y
节段名	段名Q
安全警告	安全性警告
安全信息	安全Y
安全设置数值	安全O定值
安全对象模型	安全物件模型
安全性支持供应商介面 (SSPI)	安全性支援提供者介面 (SSPI)
安全向导	安全精`
安全标识码 (SID)	安全Rea (SID)
安全标识码	安全Rea
部分架构	部分方案
全部选定	全x
选定组	x取群M
全部选定	全x
选择整个文档	x裾份的文件
可选定的	可x取的
选定文字	x取文字
选择对象	x裎锛
所选内容	x竦牟糠
选择陈述式 	x耜述式
选定跟踪 	x取追
自解压缩 .exe 文件	自解嚎s .exe n案
独立的 	立的
自我联结 	自我Y
号志	I
发送文件	l出n案
传感器	感知器
分隔页文件	分隔n案
分隔页文件	分隔n案
数字分组符号	位捣指舴
分隔符	分隔字元
循序评估运算符	循序u估\算子
序列号	序
服务器总管	伺服器管
服务器扩充功能	伺服器U充功能
服务器应用程序	伺服器用程式
服务器文档	伺服器文件
服务器项	伺服器目
服务端对象	伺服端物件
服务器进程	伺服器M程
服务程序	伺服程式
服务器脚本	伺服器_本
服务程序	伺服程式
服务器	伺服器
服务器端组件	伺服器端元件
服务组件	服赵件
服务供应商	服仗峁┱
服务供应商	服仗峁┱
期间标识码	期gRea
连接期间对象	B期g物件
无会议期间的 ASP 网页	o工作A段的 ASP W
设置作用点	O定作用c
设成默认值	O成AO值
设置为	O定
设置缩略图	O定sD
安装控制面板	O定控制台
设置电源方案	源方案O定
设置数值	O定值
设置值	O定值
配置完成	O定完成
设置	O定
表层复制 	表友}u
文件和打印共享	分享n案及印表C
共享级	共用
共用组件	共用元件
共享文件	共享的n案
共用库	共用程式
共用内存	共用w
共享质量	共享品|
共享冲突	共享`
锐利图片视频	J利D片
移位运算符	移位\算子
最少生成 	最少\算
短整数 	短整
短整数 	短整
热键	快速I
热键菜单	快速I功能表
快捷方式名	捷矫Q
快捷方式指向	捷⒄
快捷方式	捷
显示无框线项目标边框	@示o框目的框
显示调用端	@示呼叫端
显示调用	@示呼叫
显示程序代码字节	@示代a位元M
同层网页 	同泳W
同级别窗口 	同蛹窗
同级别 	同蛹
副作用 	副作用
正负号位	正位元
签名码 	名a
带正负号的整数 	д的整
带正负号的值 	д的值
无信息模式 	o息模式
简易对象访问协议 (SOAP)	易物件存取通f定 (SOAP)
简单绑定	卫MY
简单系结	卫MY
单击	按一下
单乐器	我菲
单精准浮点数	尉矢↑c
单一字节字符集 (SBCS)	我晃辉M字元集 (SBCS)
单行编辑控件	涡芯控制
单向链接串列	蜗蜻BY串列
站点结构图	W站YD
站点使用权	站台使用
站点结构文件	W站Yn案
站点转换	W站DQ
站点	站台
站点	W站
站点组件	站台元件
均匀排列	NR格
基本架构应用程序	基本架用程式
小图标	小D示
小型内存模型	小型w模型
智能型编辑器错误	智慧型器e`
智能标签 Plugins	智慧嘶` Plugins
智能标签 SDK	智慧嘶` SDK
智能型指标	智慧型指
智能终端	智慧型K端C
智能	智慧
快照数据录集	快照Y料集
快照发送	快照魉
套接字	通端
软断开	中
软件开发者套件	w_l者套件
软件开发套件 (SDK)	w_l套件 (SDK)
软件	w
方案配置	方案MB
方案数据库服务器	方案Y料焖欧器
方案文件名	方案n案名Q
方案对象	方案物件
升序排序	f增排序
降序排序	fp排序
排序文件	排序n案
声卡	音效卡
声卡	音效卡
声音方案	音效方案
原始字符集	碓醋衷集
源代码控制	碓闯淌酱a控制
源代码编辑器	碓闯淌酱a器
源代码	碓闯淌酱a
源匣	碓聪
源文件	碓n案
源格式	碓锤袷
源链接	碓催BY
源网页	碓淳W
源路径	碓绰
源项目类型	碓０割型
源	碓
原始文件	原始n案
原始程序代码控制系统	原始程式a控制系y
合并	合
特殊字符	特殊字元
特化	特殊化
拼写检查	拼字z查
拼写	拼字
微调控件	微{控制
拆分条	分隔列
拆分方块	分隔方K
拆分素材	分割素材
分隔组对象	分隔群M物件
拆分场景	分割鼍
分隔条	分隔列
后台打印数据格式	多工n理Y料格式
后台打印	多工n理
静态分割窗口	oB分割窗
SQL 数据库	SQL Y料
栈分派	堆B分派
栈检查	堆Bz查
栈框架	堆B框架
栈上限溢位	堆B上限溢位
栈重叠	堆B重B
栈探查	堆B探查
栈大小	堆B大小
栈下限溢位	堆B下限溢位
栈辗转开解	堆BD_解
栈核实行程	堆B查核行程
栈	堆B
开发用服务器	_l用伺服器
过时的程序代码	^r的程式a
独立程序代码	立程式a
独立对象	立物件
独立应用程序	立用程式
标准数据格式库	寿Y料格式程式
标准程序文件	绦n案
标准事件	适录
标准通用标志语言 (SGML)	释ㄓ擞Z言 (SGML)
标准的应用程序套件	实用程式套件
标准控件	士刂祈
标准类型转换	暑型DQ
标准错误设备 	叔e`b置
标准键入设备	瘦入b置
标准输出入 (I/O)	瘦出入 (I/O)
标准程式库	食淌
标准模块	誓＝M
标准输出设备	瘦出b置
标准资源	寿Y源
标准卷轴	暂S
标准模板库	誓０宄淌
启动帮助	椭
开始菜单	_始功能表
“开始”菜单	_始功能表
启动模式	幽Ｊ
初始网页	起始W
起始位置	_始位置
初始应用程序	起始用程式
初始文件 	起始n案
启始程序代码 	⑹汲淌酱a
启动表单	颖
启动特性	犹匦
状态信息	BY
没有状态 	]有B
语句	述句
陈述式 	述式
静态绑定	oBMY
静态组件	oB元件
静态控件	oB控制
静态数据指标	oBY料指
静态数据成员	oBY料成T
静态数据	oBY料
静态扩展 	oB延伸
静态链接	oBBY
静态成员函式 	oB成T函式
静态对象	oB物件
静态分隔窗口	oB分隔窗
静态保存类	oBΥ骖e
静态类型信息 	oB型Y
静态 	oB
静态链接库	oBBY程式
静态类型 	oB型
状态栏	B列
状态栏	B列
状态栏	B列
模板 	模板
依命令逐步运行	依命令逐步绦
依行逐步运行	依行逐步绦
依陈述式逐步运行	依述式逐步绦
逐步运行单位	逐步绦挝
逐步运行至特定处	逐步绦兄撂囟ㄌ
粘附应用程序	粘附用程式
内置事件 	冉ㄊ录
内置特性	冉ㄌ匦
保存类	Υ骖e
保存对象	Υ嫖锛
保存区	Υ^
保存体	Υ骟w
预存程序 	A存程序
保存项目	Υ骓目
情景线	故事板
流式 I/O 	串流 I/O
流式文件对象 	串流n案物件
流式对象 	串流物件
流式套接字	串流通端
流式	串流
流式媒体	串流媒w
流式	Y料流
复杂生成简化	}s\算化
烈度	度
字符串编辑器	字串器
字符串串连运算符	字串串B\算子
字符串常量	字串常
字符串表达式	字串\算式
字符串标识码	字串Rea
字符串常值 	字串常值
字符串名称	字串名Q
字符串共用 	字串共用
字符串资源	字串Y源
字符串数据表 	字串Y料表
字符串变量名称	字串得Q
字符串	字串
字符串比较作业	字串比^作I
单项工作列表	雾工作清
结构化保存体	Y化Υ骟w
Stub 文件	Stub n案
Stub 库	Stub 程式
样式生成器	邮疆a生器
样式位	邮轿辉
样式预先设置	邮筋A先O定
子网掩码	子W路遮罩
子地址	子位址
子类	子e
子类化	子e化
子数据工作表	子Y料工作表
再分割情景	再分割鼍
子表达式	子\算式
子文件类型	子n案型
子文件	子n案
子文件夹	子Y料A
子文件夹	子Y料A
子菜单	子功能表
发送者	魉驼
子网掩码	子W路遮罩
子对象	子物件
子程序	子程式
注标 	]
订阅数据库	Y料
子字符串	子字串
子类	子e
后置字符	後置字元
夏时制	夏令rg
周日	L日
超级用户	O督人
供应商	提供者
支持	支援
交换文件	交Qn案
切换控制级别	切Q控制蛹
打开任务列表	切Q到其他的作I
切换到下一个文档窗口	切Q到下一文件窗
切换到上一个文档窗口	切Q到上一文件窗
符号调试信息 	符慑eY
符号调试信息 	符慑eY
同步对象 	同步物件
同步处理 	同步理
同步文件夹	同步Y料A
同步 	同步
同步调用 	同步呼叫
同步作业 	同步作I
同步副本	同步浞
同义数据表 	同xY料表
系统剪贴板	系y剪N簿
系统数据库	系yY料
系统文件	系yn案
系统字体	系y字型
系统标识字 	系yRe字
系统日志	系y日I
系统强制响应对话框 	系y制回υ方K
系统的对象	系y的物件
系统调色板	系y色板
系统注册表	系y]员
系统托盘	系y匣
系统托盘	系y匣
系统托盘	系y匣
页签控件	`控制
跳格键	定位I
页签	`
数据表阶层	Y料表A
数据表词汇	Y料表~
数据表	Y料表
表格化对象	表格化物件
表格类型的数据录集	表格型的Y料集
数据表文件夹	Y料表Y料A
制表符	定位字元
表格式数据	表格式Y料
标签	嘶`
带入视频	入
目标文件夹	目的Y料A
目标计算机	目穗X
目标网页	目的W
目标类型 	目祟型
目标 	目
任务列表	工作清
任务栏	工作列
任务句柄	工作句柄
任务管理器	工作管理器
任务	工作
任务栏	工作列
出租车	程
TCP 通道协议	TCP 通道通f定
技术提示 	技g提示
模板参数推导	模板引低
模板参量	模板引
模板类	模板e
暂存磁盘	捍娲诺
临时文件	rn案
暂存对象	捍嫖锛
暂存窗口	捍嬉窗
终端屏幕	K端C幕
终端	K端C
三元运算符	三元\算子
文本文件	文字n案
文本模式	文字模式
文本位置	文字位置
文本对齐旗标	文字R旗
文本方块	文字方K
文本方块图案	文字方KD案
泰王国	泰
IDPK 的核心文件	IDPK 的核心n案
运行时授权标识码	绦r授嘧Rea
最后一条	最後一P
布景主题	丫爸黝}
第三次浪潮	第三波
此一连接	此一B
该设备	@b置
此一文件	此一n案
这个文件	@n案
该选项	@x
该程序	@程式
该用户	@使用者
线程标识码	程Rea
线程栏	程列
线程区域保存区	程^域Υ^
三态复选框	三S核取方K
缩略图表示	sD表示
缩略图	sD
周四	L四
刻度标志	刻度擞
水平平铺	水平K排
垂直平铺	垂直K排
超时	逾r
校时服务器	校r伺服器
时钟设置	rgO定
超时值	逾r值
超时	逾r
超时	逾r
计时器标识码	r器Rea
向左或向右	往左或往右
卫生间	所
音频式电话	按I式
墨粉	碳粉
工具信息模型	工具Y模型
工具窗口	工具窗
工具栏编辑器	工具列器
工具栏	工具列
工具箱卷轴按钮	工具箱暂S按o
最上层窗口	最上右窗
最上层显示窗口	最上语@示窗
跟踪级别	追蛹
跟踪信息	追息
轨迹	E
跟踪	追
后随字节	後S位元M
培训	
异动日志文件	尤照In案
传输协议 (TCP)	鬏通f定 (TCP)
暂时性数据汇总工具	r性Y料】工具
晶体管	晶w
过渡持续时间	D龀掷mrg
开始发送	初始化魉
正在传输	魉椭
传输协议	鬏通f定
树查看	z
三并词	三阍~
疑难解答	疑y排解
TrueType 字体	TrueType 字型
Try 列块	Try ^K
周二	L二
教程	教Wn程
在这里键入	在@eI入
类型信息模型	型Y模型
类型库	型程式
类型转换符	型DQ子
类型宣告字符	型宣告字元
类型信息	型Y
类型库文件	型程式n案
链接类型	BY型
类型宣告字符	型宣告字元
无类型程序设计	o型程式O
台风	UL
超声波	超音波
一元运算符	一元\算子
自主式运行	自主式绦
无法用	不可使用
不可用	o法使用
取消备注	取消]解
下划线	底
基础数据表	基AY料表
撤销签出	驮出
撤销旗标	驮旗
还原上次操作	驮上次的幼
还原上次操作	驮上次的幼
已撤销	已驮
异常错误	意外的e`
制式数据传输	制式Y料鬏
通用独一标识码	通用一Rea
未知的	不明的
未知	不
断开网络驱动器	中嗑W路磁碟C
无标题的书签	未命名的`
无法识别的模式	o法Re的方案
无法识别的	o法辨R的
删除注册	移除]
可变大小数组	可大小列
无标题	未命名
上下按钮控件	上下按o控制
更新处理函数	更新理函式
更新信息	更新Y
更新 OLE 对象	更新 OLE 物件
上限 	上限
向上兼容子集 	向上相容子集
需要用户干预	需要使用者介入
使用过文件	使用^n案
已用空间	使用空g
用户控件 	使用者控制
用户控件	使用者控制
用户数据包协议	使用者Y料包通f定
用户定义类型	使用者定x型
用户定义	使用者定x
用户定义信息	使用者定x息
用户文件	使用者文件
用户定义操作符	使用者定x\算子
用户标识码	使用者Rea
用户帐户	使用者
用户定义数据类型	使用者定xY料型
用户操作	使用者介入
用户级	使用者
用户列表	使用者清
用户名	使用者名Q
用户概况表	使用者概r表
用户数据表	使用者Y料表
用户	使用者
用户定义数据类型	使用者定xY料型
用户定义信息	使用者定x息
用户定义运算符	使用者定x\算子
使用介面对象	使用介面物件
使用帮助	使用f明
公用程序	公用程式
有效连接字符串	有效B接字串
可变个数参量	可狄
变量	
Variant 表达式	Variant \算式
VBA 项目	VBA ０
矢量字体	向量字型
矢量	向量
操作	幼
冗长	繁
变量	
版本信息	版本Y
纵向平铺窗口	垂直K排
可行函数	可行函式
视频编码解码器	a解a器
可视会议	h
视频编码	a
Windows 视频	Video for Windows
视频输入	入
视频输入	入
视频输出	出
视频输出	出
摄像机	z影C
视频流	串流
录像带	影
视频	
查看差异	z差
查看分页符号	z分符
查看器窗格	z器窗格
查看器	z器
查看区原点	z^原c
查看区	z^
查看	z
虚拟基底类	M基底e
虚拟设备驱动程序	Mb置映淌
虚拟内存	Mw
虚拟专用网	M私人W路
视觉化设计工具 	X化O工具
画外音	旁白
虚值指标 	值指
虚值 	值
墙纸	桌布
监看表达式	O看\算式
波形设备	波b置
波形格式	波格式
波形音频	波形音效
弱式外部链接	弱式外部BY
站点	W站
网络广播 	W路V播
网页或文件	W或n案
周三	L三
周末	L末
泛空白字符	泛空白字元
全词匹配	全字拼
宽字符	字元
宽字符常量	字元常
全半角须相符	全半形相符
通配符	f用字元
通配符	f用字元
窗口对象	窗物件
窗口特性	窗特性
窗口类	窗e
窗口宽高 	窗高
窗口句柄	窗句柄
窗口源	窗源
窗口程序 	窗程序
窗口方框 	窗方框
窗口样式	窗邮
窗口	窗
无窗口控件	o窗控制
Windows 会期期间	Windows 工作期g
智能	智慧
向导管理器	精`管理器
向导	精`
WMI 事件供应商	WMI 事件提供者
WMI 实例供应商	WMI w提供者
文字处理	文理
词	字
单词	巫
劳动日	工作日
工作簿对象	工作簿物件
背景工作线程 	背景工作程
工作流程处理向导	工作流程理精`
工作流程工具栏控件	工作流程工具列控制
工作流程操作	工作流程幼
工作流程部署向导	工作流程部署精`
工作流程对象	工作流程物件
工作流程状态栏	工作流程B列
工作流程数据表	工作流程Y料表
工作文件	工作n案
工作组	工作群M
工作区配置文件	工作^MBn案
工作区选项文件	工作^xn案
工作区窗口	工作^窗
全球信息网	全球YW
滚动磁盘栏	哟诺列
滚动工具栏	庸ぞ吡
包装函式类	包b函式e
只写	唯
只写	唯
以零为基准的索引	以零榛实乃饕
邮政编码	]f^
光盘记录暂存区	光碟捍^
光盘内容表	光碟热荼
摘要文件	摘要n案
准确地	蚀_地
音频光盘	音光碟
音频轨段	音段
音频采集	音X取
音频序列	音序列
音频光盘	音光碟
文献文件	文In案
空白光盘	空白光碟
可开机光盘	可_C光碟
启动载入模式	虞d入模式
刻录影像	影像
刻录设置数值	O定值
刻录	
刻录进程	绦羞M程
总线类型	R流排型
激光功率校测区	雷射功率校y^
复制光盘	}u光碟
光盘录制	光碟u
光盘刻录机	光碟C
只读光驱	唯x光碟C
可抹写光盘刻录机	可抹光碟C
光盘写录机	光碟C
光盘复制	光碟}u
可录式光盘	可式光碟
光盘刻录机	光碟C
可抹写式光盘	可抹式光碟
光盘文字功能	光碟文字功能
关闭光盘	P]光碟
恒定比特率	固定位元率
版权文件	版n案
循环冗余检查 (CRC)	循h冗Nz查 (CRC)
循环冗余检查 (CRC)	循h冗Nz查 (CRC)
数据筹备	Y料I
数据轨段	Y料段
禁用	停用
光盘一次写录 (DAO)	光碟一次 (DAO)
光盘标签	光碟嘶`
光盘一次写录 (DAO)	光碟一次 (DAO)
光盘匣门打开	光碟匣T_
光盘匣门	光碟匣T
退出光盘	退出光碟
启用	⒂
退出时间	Y束rg
均衡器	等化器
快速复制 (即时写录)	快速}u (即r)
文件系统	n案系y
最终化光盘	KY最K化光碟
最终化光盘	最K化光碟
固件	gw
影像刻录机	影像C
标签	嘶`
链接/读入/读出	BY/x入/x出
主要光盘	主要光碟
混合模式光盘	混合模式光碟
挂载	燧d
正在挂载	正在燧d
原生音频	原生音
真时	即r
真时	即r
超量刻录光盘	超量光碟
超量刻录	超量
重叠音频	重B音
超量刻录	超量
数据包写入	封包入
填补列块	填a^K
优先级	先等
抚静音频	犰o音
未经处理数据	未理Y料
录制的光盘	u的光碟
刻录机	C
多余音频	多N音
剩余时间	剩Nrg
设置数值	O定值
仿真	模M
源媒体	碓疵襟w
标准编辑的	示的
标准编辑	示
系统标识符	系yRea
轨段列表格式	段清胃袷
解除挂载	解除燧d
正在解除挂载	正在解除燧d
可变比特率	可位元率
虚拟光盘	M光碟
卷辑标签	卷嘶`
卷辑设置	卷O定
卷辑创建时间	卷建立日期
卷辑生效日期	卷有效日期
桦色	迳
镉绿	kG
镉红	kt
深镉黄	深kS
浅镉黄	\kS
寻麻酒色	n麻酒色
钴蓝	{
钴绿	G
钴紫罗兰	紫_m
朱鹭色	朱色
深橄榄绿	深橄炀G
深橄榄绿	深橄炀G
法国绀青	法C青
镉橙	k橙
镉黄	kS
灰橄榄色	灰橄焐
里叶色	e~色
拿波里黄	拿波里S
橄榄绿	橄炀G
橄榄黄	橄禳S
秘鲁褐	z褐
焦茶─深褐	焦茶―深褐
钛白	白
绀蓝	C{
视图(&V)	z(&V)
快速键字符串	快速I字串
活动文件	作用中的n案
添加帮助文件	加入f明n案
高级排序	MA排序
全部大写的单词	全部大的巫
允许多重实例	允S多重w
DOS box 撷取备选方案	DOS box X取溥x方案
总在最前面	最上语@示
排列图标	排列D示
ascii 字符对照表	ascii 字元φ毡
分配	指派
自动更改	自幼更
书签	`
字首大写的单词	字首大的巫
层叠窗口	重B@示
居中	置中R
列块居中	^K置中R
字符分隔	字元分隔
清除所有书签	清除所有`
剪贴板	剪N簿
列块模式	^K模式
列块	^K
添加注释	加入]
移除注释	移除]
注释	]
比较文件	比^n案
建议更改	建h更
转换为字符分隔	DQ樽衷分隔
浮动图标工具栏	浮D示工具列
当前分配	目前指派
剪切列块	剪下^K
删除活动文件	h除作用中n案
删除列块	h除^K
差异处以颜色区分	差以色彩^分
差异处以并行显示	差以K列@示
禁用分隔线	停用分隔
显示标尺	@示尺
重复的单词	重}的巫
重复复制窗口	重u窗
编辑宏	巨集
退出	x_
收藏的文件	最鄣n案
文件描述	n案描述
文件增量	n案增量
文件树	n案
填充段落	填M段落
批量文件查找	多重n案ふ
查找下一个	ふ蚁乱
查找符号	ふ曳
全屏方式	全幕模式
函数列表	函式清
反向缩进	凸排
hex 复制选定的查看区	hex }ux取的z^
hex 转到	hex 前往
高亮显示类型	高亮度@示型
清理 html 源代码	清理 html 碓创a
搜索最符合	搜ぷ罘合
缩进空格数	s排空格
缩进	s排
插入颜色	插入色彩
插入/填充列块	插入/填M^K
实例	w
左对齐	靠左R
列块左对齐	^K靠左R
行尾字符	行尾字元
宏列表	巨集清
创建副本/备份	建立副本/浞
匹配大小写	符合大小
菜单外观	功能表外^
打印时参照显示字体	列印r⒄诊@示字型
新建项目	新增０
下一个书签	下一`
下一个窗口	下一窗
不做高亮显示	不做高亮度@示
从 ftp 打开	 ftp _
打开项目	_０
输出窗口	出窗
分页符	分符
页面设置	面O定
运行宏	绦芯藜
多次运行宏	多次绦芯藜
快显菜单	快@功能表
打印所有文件	列印所有n案
打印预览	A[列印
打印设置	列印O定
快速打开	快速_
快速录制宏	快速u巨集
只读	唯x
最近使用的文件	最近使用的n案
最近使用的项目	最近使用的０
录制宏	u巨集
正规表达式	常表示式
选定区重新缩进	x取^重新s排
重命名文件	重新命名n案
批量文件替换	多重n案取代
替换	取代
复位为默认字体	重O轭AO字型
恢复原保存状态	恢驮ΥB
右对齐	靠右R
列块右对齐	^K靠右R
运行 windows 程序	绦 windows 程式
保存全部	Υ嫒部
保存到 ftp	Υ娴 ftp
选定区另存为	x取^另存
保存	Υ
全部选定	全x
选定一行	x取一行
选定范围	x取
选定单词	x取巫
设置自动加载的宏	O定自虞d入的巨集
设置颜色	O定色彩
设置纵列标记	O定v列擞
设置显示字体	O定@示字型
设置 hex/列块字体	O定 hex/^K字型
设置打印机字体	O定印表C字型
在浏览器中显示	在g[器中@示
将分页符显示为一行	⒎猪符@示橐恍
显示空格/制表符	@示空格/定位字元
拼写检测	拼字z查
拼写检测	拼字z查
拆分窗口	分割窗
拆分单词	分割巫
状态栏	B列
停止录制宏	停止u巨集
列块数字总和	^K底挚和
选定区数字总和	x取^底挚和
同步滚动	同步
语法高亮颜色显示	Z法高亮度色彩@示
语法高亮显示	Z法高亮度@示
系统托盘	系y匣
页签	`
标签列表	嘶`清
模板列表	模板清
水平平铺	水平K排
垂直平铺	垂直K排
切换书签	切Q`
工具配置	工具MB
工具栏	工具列
撤销	驮
用户模板	使用者模板
高亮显示类型	高亮度@示型
计算单词数目	算巫的
大小写混合的单词	大小混合的巫
含数字的单词	含底值巫
地址簿	通
附加文件	附加n案
密件抄送	密件副本
抄送	副本
检查邮件	z查信件
草稿箱	草稿匣
已转发	已D信
发件人	l信人
历史	v史
超链接	超BY
收件箱	收信匣
收件箱	收信匣
内送的邮件	人偷男偶
垃圾邮件	垃圾信件
标签	嘶`
邮件位址	信件位址
邮件文件夹	信件Y料A
邮件服务器	信件伺服器
邮件系统	信件系y
邮件	信件
邮件箱	信件匣
人工过滤	手舆^V
邮件	信件
with	message
昵称	糠Q
发件箱	l信匣
发件箱	l信匣
外送的邮件	外送的信件
插件	外斐淌
优先级	先等
队列	辛
已队列	已辛
引言层级	level
收件人	收信人
收件	收信
已修复	已修
重定向	重新向
已重定向	已重新向
回覆地址	回覆位址
回覆全部	all
回覆模板使用	回覆本使用
回覆地址	回覆位址
送到浏览器	送到g[器
发件	l信
发件人	l信人
	服掌髡JC
服务器状态	伺服器B
样式文本	邮轿淖
已定时队列	已定r辛
收件人	收信人
回收站	回收筒
查看源代码	z碓创a
添加裁切行	加入裁切行
窗口最上层	窗最上
压缩文件	嚎sn案
升序	f增
层叠窗口	重B@示
串联菜单	串功能表
时钟	r
颜色方案	色彩方案
颜色 	色彩
快显菜单	快@功能表
复制磁盘	}u磁碟
当前的路径	目前的路
自定义放大	自放大
自定义	自
明细查看	z
明细	
数字时钟	滴r
DOS 命令行	DOS 指令行
清空回收站	清空Y源回收筒
抹除软盘	抹除磁片
抹除磁盘	抹除磁碟
展开文件夹	展_Y料A
文件列表	n案清
文件跟踪器	n案追器
查找	ふ
浮动图标工具栏	浮D示工具列
浮动图标工具栏	浮D示工具列
文件夹跟踪器	Y料A追器
格式化磁盘	格式化磁碟
剩余图形接口资源	剩ND形介面Y源
剩余内存	剩Nw
剩余空间	剩N空g
剩余系统资源	剩N系yY源
剩余用户资源	剩N使用者Y源
群组重命名	群M重新命名
16 进制倾印	16 M位A印
标签磁盘	嘶`磁碟
大图标	大D示
列表	清
制作开机磁盘	u作_C磁碟
制造商	u造商
映射网络驱动器	W路磁碟C
图元文件	中^n案
多重卷标压缩	多重卷嚎s
多重查看	多重z
新建超然的工具栏	新增超然的工具列
打印数量	列印盗
播放列表	播放清
打印跨页	列印跨
打印管理员	列印管理T
打印缩放	列印s放
打印到文件	列印到n案
快速运行	快速绦
快速查看	快速z
只读	唯x
只读	唯x
精链	精
计算机重新启动	X重新
查找	搜
序列号	序
小图标	小D示
“开始”菜单	_始功能表
状态栏	B列
粘附应用程序	粘附用程式
子类型 	子型
子文件类型	子n案型
子文件夹	子Y料A
系统性能	系y效能
任务栏	工作列
线程	绦芯w
横向平铺窗口	水平K排
纵向平铺窗口	垂直K排
超时	逾r
断开网络驱动器	中嗑W路磁碟C
查看器窗格	z器窗格
查看器	z器
滚动磁盘栏	哟诺列
滚动工具栏	庸ぞ吡
只写	唯
背景颜色	背景色彩
阻断操作	阻嘧I
边缘颜色	色彩
候选键 	候xI
颜色顺序	色彩序
颜色转译	色彩Dg
十字光标	十字游
延迟光标	延t游
前景颜色	前景色彩
前景颜色	前景色彩
灰度分类	灰A分
灰度选项	灰Ax
灰度样式	灰A邮
灰度	灰A
重新采样	重新取
标尺	尺
子文件类型	子n案型
过渡选项	D鲞x
视频编码	嚎s
视频显示	@示
视频格式	格式
视频来源	碓
阿拉伯文 (卡塔尔)	阿拉伯文 (卡_)
阿拉伯文 (沙特阿拉伯)	阿拉伯文 (沙醯匕⒗伯)
阿拉伯文 (阿拉伯联合酋长国)	阿拉伯文 (阿拉伯合大公)
阿拉伯文 (也门)	阿拉伯文 (~T)
阿泽里文 (西里尔)	阿衫镂 (斯拉夫)
阿泽里文 (拉丁)	阿衫镂 (拉丁)
布里敦文	布里敦文
卡塔尔隆尼亚文	卡_隆尼文
克罗地亚文	克_埃西文
克罗地亚塞尔维亚文	克_埃西塞S文
西里尔文	斯拉夫文
荷兰文 (标准)	荷m文 ()
英文 (贝里斯)	英文 (里斯)
英文 (新西兰)	英文 (~西m)
英文 (特立尼达和多巴哥)	英文 (千里_)
英文 (津巴布韦)	英文 (辛巴威)
埃塞俄比亚文	衣索比文
法文 (马里)	法文 (R利)
法文 (标准)	法文 ()
法文 (扎伊尔)	法文 (_伊)
夫里斯兰文 (荷兰)	夫里斯m文 (荷m)
加里斯亚文	加里斯文
德文 (列支敦士登)	德文 (列支敦斯登)
德文 (标准)	德文 ()
义大利文 (标准)	x大利文 ()
马来文 (文莱达鲁萨兰)	R砦 (汶R)
瑙鲁文	Z文
葡萄牙文 (标准)	葡萄牙文 ()
里托罗曼斯文	里托_曼斯文
罗马尼亚文 (标准)	_R尼文 ()
俄文 (标准)	俄文 ()
塞尔维亚文 (西里尔)	塞S文 (斯拉夫)
索马里文	索R利文
索马里	索R利
西班牙文 (哥斯达黎加)	西班牙文 (哥斯大黎加)
西班牙文 (多米尼加)	西班牙文 (多明尼加)
西班牙文 (厄瓜多尔)	西班牙文 (厄瓜多)
西班牙文 (危地马拉)	西班牙文 (瓜地R拉)
西班牙文 (洪都拉斯)	西班牙文 (宏都拉斯)
史瓦西里文	史瓦西里文
鞑靼文	^靼文
乌兹别克文 (西里尔)	跗e克文 (斯拉夫)
ASF 文件	ASF n案
AVI 文件	AVI n案
Flash 文件	Flash n案
四字符编码	四字元a
MPEG 音频层	MPEG 音
MPEG2 文件	MPEG2 n案
电影标识标签	影俗R嘶`
RIFF 文字的信息明细	RIFF 文字的Y
RealMedia 文件	RealMedia n案
WMV 文件	WMV n案
附加的标头数据	~外的祟^Y料
模拟视频	比
文件位置	n案位置
音频格式	音格式
音频流式格式	音串流格式
音频串	音串
音频/视频数据	音/Y料
音频/视频交错文件	音/交en案
平均数据	平均Y料
阻断对齐数据	阻RY料
列块大小	^K大小
压缩算法	嚎s演算法
计算机游戏	X[
版权数据	版噘Y料
创建时间	建立日期
数字化日期	滴换日期
数字视频	滴灰
数字化时间	滴换rg
数字化	滴换
注脚	]_
四字符码 (FourCC)	四字元a (FourCC)
四字符码	四字元a
流式帧大小	串流大小
采样频率	取宇l率
常规 MPEG 旗标	一般 MPEG 旗
历史片	v史片
家庭视频	家庭
水平分辨率	水平解析度
恐怖/神秘片	恐怖/神z片
巨象素	巨像素
每秒字节数	每秒位元M
单声道	我
音乐视频片	音芬片
神秘片	神z片
辅助位数	o助位元
每象素的位数	每像素的位元
每样本位	每颖疚辉
每行块帧数	每^K
流式数	串流
打开填补	_⑻钛a
色盘设置	色PO定
产品	a品
生产	生a
真时视频	即r
分辨率	解析度
辅助列块大小	o助^K大小
软件	w
软件	w
源来自	碓碜
源	碓
流式位	串流位元
流式格式定义块	串流格式定xK
流式格式	串流格式
流式标头	串流祟^
流式长度	串流L度
流式模式	串流模式
流式名称	串流名Q
流式优先级	串流先等
流式质量	串流品|
流式率	串流率
流式尺度	串流尺度
流式起点	串流起c
视频流	串流
演播室	工作室
技术人员 (数字化者)	技g人T (滴换者)
过渡	D
未知的音频码	未知的音a
矢量动画	向量赢
垂直分辨率	垂直解析度
视频帧大小	大小
视频标头	祟^
视频流格式	串流格式
视频串	串
相册	相簿
模拟	比
音频压缩器 	音嚎s器
音频	音
自动链接 	自舆BY
辅助文件	o助n案
带宽	l
批量捕捉	批次X取
最好质量	最好品|
最好 	最好
较好质量	^好品|
较好 	^好
浏览外观	g[外^
浏览字体	g[字型
按钮号码 	按oa
按钮 	按o
摄像机	z影C
捕捉	X取
已捕捉视频	已X取
CD 音频属性	CD 音热
CD 音频	CD 音
颜色渐层	色彩u
颜色	色彩
组合素材 	M合素材
复合视频输入	}合入
复合视频	}合
爬行 	爬行
创建章节	建立章
创建字幕	建立字幕
数据传输率 	Y料鬏率
默认	AO
数字	滴
光盘章节	光碟章
光盘菜单 	光碟x
渐隐	溶解
椭圆 	EA
淡入 	淡入
淡出 	淡出
快速扫描	快速呙
细致	@
完成 	完成
帧/秒 	/秒
剩余: 	剩N:
完全 DV 质量	完全 DV 品|
全屏	全幕
完全质量捕捉	完全品|X取
图形缓存	D形快取
良好质量	良好品|
良好 	良好
抓取视频帧	抓取
字幕 	字幕
时 	r
外观浏览器	外^g[器
主菜单 	主x
制做电影	u做影
手工链接 	手舆BY
菜单激活 	x位罨
菜单号码 	x翁a
菜单缩略图	x慰sD
菜单	x
动态按钮 	B按o
动态菜单 	Bx
下一个按钮 	下一按o
下一个章节 	下一章
 下一帧	下一
下一个菜单 	下一x
常规按钮 	一般按o
不是按钮 	不是按o
不透明度 	不透明度
 暂停	和
 播放	播放
 倒放	倒放
 播放	播放
 播放	播放
预先设置数值	A先O定值
上一个按钮 	上一按o
上一个章节 	上一章
 上一帧	上一
上一个菜单 	上一x
项目	０
质量	品|
无线电台	o_
录制画外音	u旁白
录制	u
正在渲染音频..	正在渲染音...
重复	重覆
倒放扫描	倒放呙
回带	
卷动 	
根菜单 	根x
旋转与倾斜 	旋DcA斜
场景检测	鼍y
场景索引菜单	鼍八饕x
设置光盘跳跃	O定光碟跳S
设置链接	O定BY
设置菜单按钮链接	O定x伟粹oBY
设置菜单链接 	O定x芜BY
设置返回到菜单	O定返回到x
设置缩略图	O定sD
设置	O定
共享质量	共享品|
锐利图片视频	J利D片
显示链接 	@示BY
声卡	音效卡
源匣	碓聪
源	碓
展开 	展_
准备	
流式	串流
样式预先设置	邮筋A先O定
带入视频	入
缩略图按钮 	sD按o
缩略图	sD
字幕 	字幕
过渡持续时间	D龀掷mrg
过渡	D
字体	字型
视频输入 	入
视频输入 	入
视频输出 	出
视频输出 	出
视频流	串流
视频	
画外音	旁白
划变	抹拭
变动比特率	游辉率
总在最前面	最上语@示
节拍检测	拍y
比特率	位元率
书签	`
酷特栏	酷特列
注解	]解
圆点颜色	Ac色彩
降低采样	降低取
队列	辛
EQ 均衡器	EQ 等化器
跳象素	跳像素
全屏	全幕
内插空白特技	炔蹇瞻滋匦
激光	雷射
中继数据	中^Y料
常规大小	一般大小
注释	]
补丁	aY
象素重覆	像素重覆
播放列表	播放清
插件	外斐淌
首选	偏好
静音列块	o音^K
面板浏览器	面板g[器
平滑过渡	平滑D
流式	串流
剩余时间	剩Nrg
过渡	D
变量	
视频	
水波特技	水波特效
效能查看器	效能z器
调试错输出等级	除e出等
驱动程序模块	映淌侥＝M
使用软件模拟灰阶演色	使用w模M灰A演色
使用软件仿真 RGB 对照演色	使用w模M RGB φ昭萆
硬件加速	硬w加速
使用硬件位图列块转写	使用硬wcD^KD
使用硬件颜色填充	使用硬w色彩填入
使用硬件通透性	使用硬w通透性
刷新速率	重新整理速率
已注册的服务提供者	已]缘姆仗峁┱
关于	P於
访问	存取
激活	活化
激活	活化
添加为	加入
添加到	加入到
添加	加入
编址	定址
应用	套用
分配	指派
绑定	MY
浏览	g[
调用	呼叫
回调	回呼
采集	X取
捕捉	X取
更改	更
选定	x取
单击	按一下
克隆	仿u
配置	MB
配置	MB
连接到	B到
联系	洽
复制到	}u到
复制	}u
创建	建立
自定义	自
剪切	剪下
调试	除e
声明	宣告
检测	y
禁用	停用
断开连接	中噙B
双击	按二下
拖放	拖曳
拖放	拖曳
重复复制	重u
嵌入	惹
仿真	模M
启用	⒂
枚举	列e
运行	绦
退出	x_
导出到	R出到
导出	R出
查找	ふ
修复	修
修复	修
产生	a生
运行	绦
超链接	超BY
标识	Re
实现	作
导入	R入
集成	整合
反相选定	反相x取
标签	嘶`
运行	绦
链接	BY
日志	日I
登录	登入
注销	登出
制作	u作
映射	
标志	擞
合并	合
挂载	燧d
新建	新增
通知	知
打开	_
强制替代	制覆
覆盖	覆
粘贴	N上
补丁	aY
运行	绦
打印预览	A[列印
打印到	列印到
打印	列印
队列	辛
快速查看	快速z
退出	x_
引用	引言
识别	辨R
重新连接	重新B
录制	u
录象	影
恢复	恢
重拨	重新芴
重定向	重新向
取消撤销	取消驮
引用	⒄
刷新	重新整理
注册	]
备注	湓]
重命名	重新命名
渲染	演算上色
修复	修
替换	取代
替换	取代
重新运行	重新绦
重新启动	重新
再试	重
回复	回
回带	
回滚	回
运行	绦
采样	取
扫描	呙
滚动	
查找	搜
全部选定	全x
选定	x取
发送到	魉偷
设置	O定
设置	O定
关闭系统	PC
仿真	模M
单击	按一下
跳过	略^
均匀排列	NR格
拆分	分割
启动	
逐步运行	逐步绦
保存	Υ
跟踪	追
发送	魉
下划线	底
撤销	驮
松开	_
查看为	z
查看	z
添加	加入
附加的材料	~外材料
音频事件	音事件
音频流式	音串流
画布颜色	布色彩
保存格	Υ娓
更改为	更
颜色立方体	色彩立方w
颜色集	色彩集
组件	元件
取消选定	取消x取
退出端点	Y束端c
导出预览	R出A[
导出符号	R出符
导出向导	R出精`
导出	R出
羽化选定范围	羽化x取
填色颜色	填色色彩
Flash 播放文件	Flash 放映n案
字体映射	字型τ
字体	字型
灰度色盘	灰A色P
历史	v史
导入	R入
键入色阶	入色A
(颜色)饱和度	(色彩)和度
合并	合
列间距	行距
链接向导	BY精`
映射	
鼠标事件	滑鼠事件
鼠标目标	滑鼠目
嵌套组	巢钊航M
上层菜单	上舆x
粘贴为	N上
弹出式菜单	出式x
精确光标	精_游
预先设置名称	A先O定名Q
项目日志	０溉照I
发布	l
渲染为影像	演算上色橛跋
重新采样	重新取
分辨率	解析度
回复	回
回带	
场景选定器	鼍斑x取器
暂存磁盘	捍娲诺
反相选定	反相x取
均匀排列	NR格
逐程序运行	逐程序绦
笔画颜色	P色彩
细部选定	部x取
子菜单	子x
细部选定	部x取
整体选定	整wx取
缩略图	sD
允许度	容S度
补间动画实例	ag赢w
解除组	解除群M
常规状态	一般B
作用中页签	作用中`
阻断的弹出式窗口	阻嗟出式窗
收藏夹	我的最
历史	v史
非作用中页签	非作用中`
连结栏	BY列
注册码	]源a
注册金  	]越痄
侧边栏	冗列
源代码	碓创a
状态栏	B列
页签	`
//从下面开始是从另一个网站下载的
图形用户界面	D形使用者介面
图形设备接口	D形b置介面
处理	置
头文件	祟^n案
帮助文件	f明n案
预定到期时间	AO到期rg
高级	高
个人文件夹	人Y料A
主机	主C
主页	主
主机名	主C名
HTML超文本标记语言	超文件耸菊Z言
HTTP超文本传输协议	超文件魉f定
超链接	超接
超文本	超本文
已识别数据	已ReY料
标识符	Re符
表义字符	表意文字
图片	影像
图片数据	影像Y料
图片地图	影像地D
执行	作
执行符合性声明	作符合性明
执行平台	作平_
隐性规范	[性法t
隐性WEB请求	[式W路求
非活动页	非使用中面
收件箱	收件匣
包含文件	包含n
独立软件供应商	立w供商
独立WEB	立W
独立值属性	wr值性|
通知	通知
参考文本	⒖急疚
输入项目	入目
插入列	插入
插入行	插入列
实例	例
实例数据	例Y料
实例数据节点	例Y料c
交互	互
交互式用户	互邮褂谜
界面	介面
接口定义语言	介面定xZ言
国际标准组织	H式M
国际化资源标识符	H化Y源Re符
网络协议	WHW路f定
网络服务提供商	WHW路服仗峁┱
可交互性	交互\作性
解释语言	直g式Z言
解释	直g
解释程序环境	直g器Z境
局域网	炔烤W路
无效的	o效
不可见	不可
项目	目
Java语言规范	JavaZ言
Java虚拟机	JavaMC器
JPEG图片格式	JPEGD形格式
垃圾邮件	垃圾信
键入	I入
键定位	金定位
钥匙管理	金管理
键名	金名Q
抽象文件	摘要n案
帐户	ぬ
获得	@取
取址方式	定址模式
附件	附件
音频压缩	音嚎s器
音频流	音串
视听交叉格式	AVI影音格式
平均数据率	平均Y料流量
平均值	平均值
反向引用	反向引用
贝塞尔点	控制c
立方体	p立w
二分搜索	二元搜
二叉数	二元
邦定	MY
邦定内容	MY热
位字段	位元谖
按位	逐位元
按位运算	位元\算子
混合呈图	混合映像
呈图方向	映像方向
块符号	K罘K
阻止的横幅	阻嗟M幅
阻止的弹出式窗口	阻嗟出式窗
阻止操作	阻嘧I
布尔	布林
可引导光盘	可_C光碟
自展程序	虞d入器
边框框宽度	框度
底边界	底界
界限列	界限
括号匹配	括ΨQ
带括号的表达式	有括的\算式
中断的连接	中嗟倪BY
桥路由器	蚪勇酚善
画笔	P刷
笔头	P刷^
缓冲区欠载运行	n^欠d\行
大量记录字段交换	大量Y料谖唤Q
多行存取	大量Y料列X取
商业逻辑层	I者
商业物件	I瘴锛
商业流程	I樟鞒
商业规则	I找t
按钮阴影	按o暗影
校准	校
回调字段	回呼谖
回调函数	回呼函式
卡式磁带	卡
转换	D型
选择	x取
循环依赖	循h相依
循环引用	循h⒖
类ID	eRe
裸机	初始B的X
剪裁文件	素材n案
剪裁路径	裁剪路
代码转换器	解a器
类型强制转换	制型D
通用控制	通用控制
公共数据记录	通用Y料
比较	比^元
编译器缺陷报告	g器缺失蟾
编译期错误	gr期e`
完整目标	完整物件
复杂邦定	}sMY
组成	撰
拼接键	串B索引I
拼接操作	串B\算子
并发性	K行
并发连接	同rB
连接中	使用中B
连接中断	B中
约束比例	制等比例
接触	洽
版权	版
剪除	剪裁
交叉编辑	交互
淡入淡出	交e淡
十字指针	十字游
交叉制表查询	交叉Y料表查
跨线程	跨程
插进指令表	提示表
循环冗余校验	循h冗Nz查
仪表盘	x表板
数据访问对象	DAO Y料存取物件
数据断点	Y料中帱c
数据邦定	Y料MY
数据报	Y料包
数据报套接字	Y料包通端
装饰名	b名Q
纵深副本	深友}u
延期	延t的
变形	形
等待指针	延t游
延时传送	魉脱俞
延时载入	延td入
删除至行尾	h至行尾
删除至行首	h至行首
间接引用	解⒖
导出类型	衍生型式
设计期对象	Or期物件
设计期的	H限Or期
按需拨号	S需芴
数字	底
直接连接	直接B接
目录清单对话框	目清畏K
反汇编	反Mg器
免责声明	免明
断开连接	中
光盘卷标	磁碟嘶`
弥散的	分散式
分配界面	分配介面
发抖	f色
入坞	停v
域名后缀	W域字尾
主控	主控制
点颜色	Ac色彩
点运算	句c\算子
点形状	c
点大小	Ac大小
点变量	Ac量
双击	快按纱
双倍大小	杀洞笮
两倍行距	杀缎虚g距
双精度	倍精度
降低密级  	降
下游	下游 
驱动器磁盘	映淌酱牌
驱动器名	磁碟C代
置放目标	置放目
双重界面	p重介面
转储电影	出影
动态邦定	BMY
动态数据交换	BY料交Q 
动态超文本标记语言	B超文字擞Z言
动态连接	BBY
易用	易操作
易移除	易移模式
易更新	易用更新
编辑风格	撰L格
效果类型	效果N
有效抵制	有效位址
经历时间	^rg
椭圆工具	EA形工具
环绕类型	@型式
文件结束	n案Y尾
最终用户	K端使用者
最终用户许可协议	EULA使用者授嗪霞s
增强型元文件	增型中^n案
排队	M入辛
枚举属性	列e性|
枚举类型	列e型式
结束码	Y尾a
等运算	等式\算子
等连接	等Y
擦除	抹除
错误处理器	e`理常式
错误信息	e`息
错误代码	e`代
转义字符	逸出字元
事件产生	事件冒出
事件处理器	事件理常式
事件接口	事件介面
事件侦听器	事件收器
事件程序	事件程序
事件应答对象	事件回物件
事件计划	事件方案
事件脚本程序	事件_本程序
事件接受	事件接收
事件接受映射	事件接收τ
事件处理程序	事件理程序
事件接受	事件接收
每隔行	跳式
每隔像素	跳像素
标志项集	辨R集
举例	例
异常处置器	常理常式
异常规则	常格
互斥模式	互斥模式
免除	豁免
退出并返回	退出KD回
退出帮助	退出求助
扩充内存	U充w
专家模式	＜夷Ｊ
显式初始化	外@初始O定式
显示接口成员执行	外@介面成T作
显示连接	外@BY
显示参考	外@⒖
表达式求值	\算式u估器
表达式语句	\算述式
扩展内存	延伸w
失效后资源备份	容e移D
快速载入区域	快速d入^域
特征树	特徵
字段定界符	诙界符
字段类型	谖恍褪
文件分配表	FAT n案分派表
文件截取	n案X取
文件计数	n案
文件处理	n案置
文件列表	n案表列
文件数	n案
文件类型	n案型式
文件名	n案名Q
文件扩展名	副n名
文件服务器应用	n案伺服器用
填充因素	填充因子
填充样式	填充式
填充类型	填充型式
电影片断	影片片段
最终化光盘	最K化光碟
在多个文件内查找	多重n案ふ
在项目内查找	０ふ
查找内容	ふ夷
激发	引l
激发事件	引l事件
第一个记录	第一P
固定调色板	固定色P
定长字符串	定L字串
平面合成图象	平面合成影像
浮动工具条	浮D示工具列
平面化层	平面化D
浮动工具条	浮庸ぞ吡
浮点类型	浮cY料型式
流控制	流量控制
文件夹跟踪器	Y料A追器
字型文件	字型n
字型映射	字型τ称
字型视图	字型z
强制帧大小	制框大小
强制每秒帧数	制每秒框
情景窗口	前景窗
外来图像	外碛跋
外健	外硭饕I
外健表	外硭饕I表
表格线设定	表格格O定
表格图像	表格影像
表格类型	表格型式
表格视图	表格z
形式参数	形式引
形式参数列表	形式当砹
格式化字符串	格式串
格式化工具条	格式化工具列
表格举出应用	表格基A用
正向声明	前置宣告
向前一帧	向前一框
仅向前	H正向
基础类	基Ae
四字节码	四字元a
帧/秒	框每秒
逐帧播放	逐框播放
帧控制	框控制
帧抓取	框抓取器
帧页	框
帧速率	框速率
逐帧反转	逐框反D
流帧大小	串流框大小
帧窗口	框窗
帧遗漏	z漏框
帧错误	框e`
可用位	可用位元M
可用图形界面资源	可用D形介面Y源
可用图像位	可用影像位元M
无限线程	o限制程
无限线程模型	o限制程模型
可以用户资源	可用使用者Y源
帧/秒	框每秒
全部控件	完全控制M件
完整连接	完全BY
完整外部连接	完整外部Y
完整路径	完整路矫Q
全屏模式	全幕模式
全特化	全特化
完整类名	完整e名Q
函数体	函抵黧w
函数覆盖	函岛w
函数列表	函当砹
函数对象	函滴锛
函数重写	函蹈
函数描述	函得枥L
函数范围	函倒
函数集	函导
函数层连接	函舆BY
函数过程范围	函惦r型
基本类型	基本型式
计量长度	量L度
通用算法	同傺菟惴
类属类别设定	同兕eO定
类属合成别号	同俸铣e
类属创建程序	同俳立者
获得区域	取回^
获得指针	取回指
全局默认值	全域AO值
全局对象	全域物件
全局最佳化	全域最佳化
全局规则	全域t
全局脚本	全域_本
全局样式表	全域邮奖
全局变量	全域
字形高速缓存	字符快取
抓取句柄	抓取控c
抓取视频帧	抓取框
抓取的帧	抓取框
图像用户界面	D形使用者介面
图形外观	D形外貌
图形设备接口	D形b置介面 
图形说明	D形⑹
灰色检查值	灰核χ
灰色选单项	灰x雾目
灰阶调色板	灰A色P
栅格布局	格布局
组列表	群M表列
组重命名	群M重新命名
控件组	群M方K控制
代码保护区域	程式a保o^g
保护段落	保o^段
指南	指ЬV要
导则	指
指南	指引
硬件禁用	硬w失能
处理锁定冲突	置i定n突
联络	交握
悬挂式缩进	凸排
硬回车	硬D回
硬件填充颜色	硬w填色
硬件透明	硬w透通
哈希算法	s演算法
哈希多重集	s多重集
哈希数	s
哈希表	s表
散列值	s值
标题控制	祟^控制
堆分配	堆e配置
帮助内容	求助热
帮助映射文件	求助映射n
帮助概要	求助概^
帮助项目文件	求助０n
帮助查找程序	求助搜こ淌
帮助选择	求助x
帮助主题	求助主}
异类的	|的
十六进制转储	十六M位A印
隐藏下阴影	[藏下落式影
高亮文本	醒目文字
高亮	醒目
高亮文件类型	醒目的n案型式
嘶声降低	降低嘶
点击测试代码	cya
全息图	全像
水平排列	水平K排
水平停住	水平停v
主应用程序	主用
主控	bd控制
主控能力	bd能力
主控信息	bdY
主机名	主C名Q
热键	徭I
沙漏指针	沙漏游
超链接基础地址	超BY基底
超链接文本	超文字BY
超文本置标语言	超文字擞Z言
超文本参考	超文字⒖
超文本传输协议	超文字鬏通f定
标识符前缀	Re符前Y
标识符文本	Re符文字
识别增量	Re增量
识别分割	Re分割
识别种子	ReN子
空闲传感器	f置感器
图像文件	影像n案
图像库	影像D
图像列表	影像表列
图像记录	影像器
图像序列	影像序列
图像大小	影像大小
图像编辑	影像
直接变量	直接引
执行	作
执行界面	作介面
执行定义	依作定x
执行者	作者
隐含连接	[含BY
引入数据库模板	R入Y料炷０
引入文件	R入n案
引入函数	R入函
增量备份	f增浞
递增构建	f增建置
递增连接	f增BY
递增连接器	f增BY器
递增搜索	f增搜
独立软件供应商	立wS商
索引顺序存取法	索引循序存取法
索引视图	索引z
索引子回传类型	索引子骰匦褪
间接内存运算	g接\算元
无限递归	o限f
继承层次	^承A
 初始化表达式	初始器
嵌套	套
行内组合码	行冉M合程式a
内部类别	炔款e
内阴影	炔筷影
内宽度	炔度
就地按钮	地按o
处理中组件	理中M件
处理中调试	理中慑e
输入位准	入位
插入数字	插入底
插入列	插入
填充列	填M
嵌入浮雕	嵌入浮凸
嵌入路径	插入路
内部程序	炔砍绦
检查	z
实例处理	例置
实例方法	例方法
实例变量	例
实例模型	例模型
实例模版	例影
例示	例化
电气和电子工程师协会	子C工程W
指令安排	指令排程
整型	整敌褪
综合服务数字网	整w服滴痪W路
互联方案	互B方案
接口定义语言	介面定xZ言
接口文件	介面n案
接口ID	介面Re符
接口标识符	介面Re符
接口类型	介面型式
隔行	交e
内连接	炔挎Y
互联网络控制报文协议	WHW路控制息通f定
互联网络工程任务小组	WHW路工程任招〗M
互联网络包	WHW路封包
互联网络服务器应用编程接口	WHW路伺服器用程式l展介面
互联网络服务器扩充	WHW路伺服器U充
互联网络服务器过滤器	WHW路伺服器^V器
因特网服务提供方	WHW路服展商
解释器	解g器
固有常数	冉ǔ
固有控件	冉控制
固有函数	冉ê
无效文件名	o效n名
不变表达式	不量\算式
隔离存储区	隔xΥ^
问题详细表	h}表
问题列表	h}表列
项目目录	目目
项目扩展	目延伸
项目路径	目路
迭代	迭代器
堵塞循环	堵塞圈
连接条件	Yl件
连接运算符	Y\算子
操纵杆	uU
跳转到	跳到
连接资料表	YY料表
紧排	B排
密钥对	金
密钥设定	金O定
密钥验证	金C
键盘语言及布局	IPZ言及布局
退色效用	褪色效用
λ表达式	λ表式
语言邦定	Z言MY
语言元素	Z言元件
语言标识符	Z言Re符
套锁工具	套索工具
启活	l
前导位	前位元M
导入轨	入
导出轨	С鲕
最低有效位	最低有效位元M
左边界	左限
左连接	左外部Y
合法声明	法律明
词汇分析器	Z》治銎
词汇范围	Z」
词汇空间	Z】臻g
库管理员	程式旃芾碚
许可	授
许可证协定	授嗪霞s
寿命	生命期
轻微模糊	p微模糊化
行覆盖	行涵w
行尾	行尾Y束
换行符	行分隔符
隔行	跳行
隔行字符	跳行字元
行模式	行模式
行模式浏览器	行模式g[器
链接要求	Y格
基础链接	BY基A
链接项目	BY目
链接样式工作表	BY式庸ぷ鞅
链接表管理器	BY表管理者
链接与嵌入	BYc嵌入
链接元素	BY元件
链接库	BY程式
链接条	BY列
内核	核心
列出帮助主题	列出f助主}
列表视图控件	列表z控制
列表框控件	列表方K控制
收听模式	收模式
收听者应用	收者用
文字	字面文字
文字常数	字面文字常
载入有效位指令	d入有效位址指令
负载因素	d因
按需载入	需要d入
本地拷贝目录	本地副本目
本地文件	本Cn案
本地命名	本地名Q
本地对象	^域物件
本地远端程序呼叫	本地h端程序呼叫
本地范围	^域
本地WEB应用	本地W站用
本地WEB服务器	本地W站伺服器
本地环境标识符	本地h境Re符
锁定模式	i定模式
锁定形式	i定型式
逻辑差错	e`
逻辑连接	B接
逻辑坐标系统	座讼到y
厂指针	L指
查找	查找
查找表	查找表
循环构造	圈造
循环干扰	路干_
循环最佳化	圈最佳化
松耦合	散耦合
损失	漏失
重要损失	重要漏失
无损压缩	o漏失嚎s
有损压缩	漏失嚎s
低功耗	低功率消耗
宏扩充	巨集展_
魔棒工具	魔g棒工具
邮件服务器	]件伺服器
邮件系统	]件系y
邮箱	信箱
邮递清单	]寄名
主应用窗口	主用窗
主窗口	主框架窗
主存储器	主w
主消息循环	主息圈
维护程序	So用公用程式
制作插件	u作增益功能
制作备份	u作副本/浞
管理语义	管理Z意
手动配置	手咏MBO定
多对多联系	多Χ嚓PS
映射文件	τn案
映射网络	τ尘W路
映射网络驱动器	τ尘W路磁碟C
映射网络资源	τ尘W路Y源
标记声明	耸拘告
置标模型	耸灸Ｐ
跑马灯控件	跑R艨刂
屏蔽位图	遮罩cD
屏蔽层	遮罩
屏蔽区	遮罩^
屏蔽编辑控件	被遮罩控制
大量存储设备	大量Υ嫜b置
匹配大小写	大小符合
前缀匹配	前Y符合
子字符串匹配	子字串符合
仅限全字匹配	H限全字拼符合
调色板	色版
最大化按钮	最大化按o
最大化窗口	最大化窗
最大位数每秒	最大每秒位元M
最大错误数	最大e`量
多媒体控件界面	多媒w控制介面
多文档界面	多重文件介面 
被测事件	被y量事件
中度模糊	中度模糊化
成员存取操作	成T存取\算子
成员函数	成T函
成员初始化列表	成T初始化表列
成员形式	成T型式
备忘录	渫
内存分配	w配置
内存块	w^K
内存高速缓存基础物体	w快取基底物件
内存布局	布局
内存泄露	漏失
存储器模型	模型
内存使用差异	使用差
启动选单	x
选单条	x瘟
选单控件	x慰刂
选单项	x雾目
选单编号	x翁a
选单编程	x纬淌郊
选单项目识别符	x雾目Re符
消息框	息方K
消息断点	息中帱c
消息交换样式	息交Q型
消息处理器	息置器
消息处理	息置器
消息头	息祟^
消息循环	息圈
消息可靠性	息可靠度
消息发送者	息l送者
消息处理函数	息置函
消息映射入口	息τ稠
信息应用编程接口	用程式_l饔介面
元数据	後OY料
仪表控件	量表控制
毫秒每桢	每框毫秒
小型转储	小型A印
最小重建	最少重建
厘米	米
次版本号码	次要版本a
镜像列表	R像表列
镜像站点	R射W站
丢失	z失
模型邦定表达式	模型MY表示式
模型项目	模型目
模型项目属性	模型目性|
非模态	o模式
非模块形式	o模式形式
建模语言	塑模Z言
调制解调器连接	CB接
等间距字型	等字型
月历控件	月芽刂
主题资源管理器	主}Y源管理者
主题窗口管理器	主}窗管理者
移动指南	移又敢
鼠标指针通知	滑鼠指烁嬷
鼠标目标	滑鼠目
移动文件夹	移淤Y料A
电影识别标签	影Re符嘶`
分秒桢位置	分秒框位置
多重会话	多重
多位字符集	多位元M字元集
多位编码页	多位元Ma
组播	多播
多语言	多Z文
多行编辑控件	多行控制
多语言	多Z文
多链路连接	多重BYY
多文档界面	多重文件介面
多文档类型	多重文件型式
多文件	多重n案
多选	多重x
多行编辑控件	多行控制
多选列表框	多重x癖砹蟹K
复用器	多工器
多用途的网际邮件扩充协议	多用途WHW路]件延伸
多线程	多重绦芯w
多重视图	多重z
互斥物体	互斥物件
命名变量	具名引
命名书签	具名`
命名类别	具名e
命名参数	具名
命名许可集合	具名S可集合
命名管道	具名管道
命名序列	具名序列
名称空间污染	名Q空g污染
命名规定	命名s
本原音频	原生音
本原编译器	原生g器
本原数据	原生Y料
本原错误	原生e`
自然	本|
导航列图象	в[列影像
导航	в[
向后导航	向後в[
向前导航	向前в[
导航条	в[列
导航机制	в[C制
导航结构	в[Y
嵌套	巢套
网络新闻传输协议	W路新
网络新闻传输协议	W路新魉f定
网络适配器	W路配接器
网络地址转译	W址Dg
网络字节序	W路位元M次序
网络连接	W路B接
网络组件	W路M件
正常拖拽	正常拖曳
正常初始化	正常起始
规范文字	的文字
通知信息	通知息
通知服务	通知服
通知	通知
稍微增加宽度	微增度
稍微上调	向上微{
空语句	空⑹
每像素位数	每像素位元
帧数	框
每块帧数	每^K框
流数	串流
初始帧数	初始框
数值表达式	抵当硎臼
数字小键盘	底宙I台
对象表达式	物件表示式
对象层次	物件A
目标模块	物件模M
对象模型格式	物件模M格式
对象向导	物件向
对象类型	物件型式
对象视图	物件z器
面向对象的设计	物件向O
离线发布	xl行
操作中处理	\作中
一对多联系	一Χ嚓PS
一对一联系	一σ魂PS
屏上键盘	幕IP
开启独占权限	_嘞
开发软件基金会	_放w基金
开口标签	_^嘶`
操作码	操作a
运算符前置	\算子居先
开放式并行	_放式K行
选项参数	x裥砸
选项行为	x裥孕
选项特征	x裥蕴蒯
序数索引值	循序索引值
外部连接	外部合
外部类型	外部型式
外部高亮度	外部高亮度
外部样式	在外邮
输出界面	出介面
输出单精度	出精识
输出流	出串流
外部程序	外部程序
外部区域	外部^域
覆盖图片	覆w影像
覆盖模式	覆w模式
覆盖字幕	覆w字幕
过载解析	超d解析
重载函数	重d函
重载运算符	重d\算子
重载集合	重d集合
概况	概^
复写	覆
打包向导	封b精`
打包	封包
打包整合	封包整合
打包交换	封包交Q
打包写入	封包入
填充区域	填a^K
填充粒度	填a粒度
关闭填充	P]填a
开启填充	_⑻钛a
页设计者	WO者
页错误差异	分e`差
页文件位组	分n案位元M
页面视图	面[
调色板映射	色Pτ
调色板设定	色PO定
面板设置	面板M合
段落分隔符	段落分隔符
参数块	^K
参数前缀	登爸
参数后缀	滇嶂
参数实体参考	w⒄
父类	上宇e
上级目录	上幽夸
上级文件类型	上游募型式
上级表单	上颖
上级项目	上禹目
上级选单	上舆x
上级对象	上游锛
上级页面	上禹面
上级程序	上映绦
上级表	上颖
父窗口	上右窗
父子关系	H子PS
奇偶标志	同位旗
解析影射	剖析τ
已解析字符数据	已剖析字元Y料
以解析实体	已剖析w
解析器	剖析器
先行解析错误	先行剖析e`
解析	剖析
局部理解	部分理解
地址传递	按址鬟f
参考传递	按⒖鬟f
值传递	按值鬟f
被动模式	被幽Ｊ
粘贴为	N上成
路径名	路矫Q
样式匹配	型悠ヅ
样式字符串	型幼执
峰值分页文件位	峰值分n案位元M
峰值虚拟位	峰值M位元M
对等网络	ccW路
搁置项目	R置目
周边	L
周边组建互连	LM件B接
周边设备	Lb置
固存	永久Υ嫫
保存	保存
固存	永mΥ嫫
假性目标	假性目
物理笔刷	wP刷
物理设备	wb置
物理字型	w字型
图片框	D片方K
图片渲染	D片渲染
互联网络内容选择平台	W路热莺Yx平台
插件	外
口袋书	口袋
数据成言指针	Y料成T指
成员函数指针	成T函抵
指针类型	指诵褪
多边形模式	多形模式
多边形填充模式	多形填M模式
端口	埠
端口名	埠名Q
端口号	埠a
便携式	可y式
部分	部份
节能模式	能模式
实践	
精确游标	精_游
预定义	A先定x
断言	述~
前缀符号	前置法
预连接	A先BY
预处理	前置理
预处理器	前置理器
打印管理器	列印管理者
打印	列印成品
私钥	私密金
私有变量	私用
过程ID	程序Re
产品Key	a品金
产能组件	a能M件
可编程的	可程式化
程序ID	程式ORe
程序员	程式O
放映机	投影C
属性定义	性|定x
原形	原型
代理商	供商代理
虚拟列	M行
公开识别符	公_Re符
公钥	公_金
公钥密码学	公_金密aW
公用物体	公用物件
公共在线论坛	上公共
公用程序	公用程序
公共用户	公用使用者
质量保证测试套件	品|保C
排队	辛
排队传真	辛髡
排队名称	辛忻Q
快速启动	快速_
快速记录	快速u
快速审查	快速z
快速擦除	快速抹除
引号识别符	引Re符
突起浮雕	凸起浮雕
随机水平条	SC水平l
随机垂直条	SC垂直l
随机数	y
随机列表	SC表列
随机数产生器	y诞a生器
快速应用开发	快速用程式_l 
光栅字型	c字型
光栅格	鸥窕
预读取缓冲区	A先x取n^
说明	x我n案
真实模式	真模式
记录分隔符	分隔符
记录字段交换	谖唤Q
记录审查	z
录音机	器
矩形坐标	矩形座
递归	f
刷新速率	重整速率
区域	^域
寄存器存储类别	捍嫫Υ骖e
寄存器变量	捍嫫髯
寄存器窗口	捍嫫饕窗
正则表达式	正表示式
正则表达式对象	正表示式物件
关系	PS
关系数据库	P式Y料
关系运算符	P式\算子
相对连接	相BY
相对区域	相Υ^
远程程序呼叫	h端程序呼叫
远程侦测	h端感y
重复	重}
重复次数	重}次
回复	回覆
回复地址	回覆位址
仓库	Υ
仓库引擎	Υ煲擎
废除推荐	U止推]
保留区域	保留^
资源标识符	Y源Re符
资源项目	Y源目
资源类型	Y源型式
资源察看	Y源z
返回地址	回 回鞔a
返回类型	回餍褪
返回值	回髦
反向文件顺序	反向文件次序
反向递增搜索	反向f增搜
反向慢速	慢速反向播放
撤销	撤N
右边界	右界
行指针	列指
运行时间	\行rg
运行时	\行r
运行时	\行rg
运行时间类型信息	\行rg型式Y
仅限运行时	H限\行rg
安全	安全的
安全区域	安全^域
取样深度缩放	颖旧疃瓤s放
取样大小	颖敬笮
方案保存为	方案另存
选取区域另存为	x取^另存
可缩放	可s放性
扫描码	呙璐a
日程	排程
结构描述设计	Y描述O工具
屏幕坐标	幕座
记录员	hT
滚动快	臃K
滚动条	暂S
无线连接	o接pY
搜索条件	搜l件
搜索准则	搜t
搜索次序	搜ご涡
搜索结果	搜そY果
搜索目标	搜つ
切割	正割
次要依赖信息	次要相依Y
次要界面	次要介面
安全警告	安全警告
安全标识符	安全Re符
安全支持提供者接口	安全支援提供者介面
亦参见	亦⒄
反向选择	反相x取
自解压的	自我解嚎s
在连接	自我Y
语义WEB	Z意W
语义透明	Z意透明
语义	Z意
发送	l送
重新发送	重新l送
移到下层	移到最下
发送至浏览器	送至g[器
可发送	可l送
发送者	l送者
敏感性	敏感度
传感器	感y器
分隔字符	分隔符字元
有序的	循序
有序容器	循序容器
有序导航	循序Ш
有序评估运算符	循序u估\算子
序列界面	序列介面
串口	序列埠
串行传输层	序列鬏
服务器管理器	伺服器管
服务器扩充	伺服器U充功能
服务器段组件	伺服器端元件
服务组件	服战M件
服务接口	服战槊
服务语义	服照Z意
会话ID	^段Rea
会话名称	^段名Q
会话对象	^段物件
设为默认值	O成AO值
设定光盘跳	O定光碟跳S
设定连接	O定BY
设定选单连接	O定x芜BY
设定打印机字体	O定印表C字型
设定返回到选单	O定返回到x
设定电源方案	源方案O定
设制完成	O定完成
阴影复制	表友}u