w	内存
硬碟	硬盘
P於	关于
抽象模M	抽象模块
存取、接取	访问，存取；访问，存取；访问，存取
存取控制	访问控制
存取控制Y	访问控制信息
存取I	访问钥
存取C制	存取机构
存取模式	存取方式
存取S可	访问许可
存取	访问权限
存取格符	方案要求
存取性Y	可访问性信息
存取性}	可访问性问题
可存取的	可访问的
o障KW作	
可存取性	可访问性
配件；附用程式	附件
XA右	听觉串联样式表
幼	动作
	启动
⒂霉ぷ髑	启动工作列表
樱换	激活；激活
⒂梦姆	先用语法
使用中的面	活动页
活	活动
V告M幅	广告条
{m	修改
{m偏好	修改选项
新增	添加
新增用程式	添加应用程序
新增	添加为
新增`	添加书签
新增映淌	添加设备驱动程序
新增F有目	添加现有项目
新增Y料A	新建文件夹
新增硬w	添加硬件
新增目	添加项目
新增０	添加工程/项目
增益功能	后加
增益集	后加集
附加	附加
附加字元	附加字符
位址;地址	地址
通	地址簿
定址	寻（定）址
管理主控台	管理控制台
管理者	管理员
管理者ぬ	管理员账号
MA	高级；先进
AIX 高交绦谐绦	先进交互式执行(AIX)[操作系统]
ALSA 高Linux音架	高级Linux声音架构
F、J委T	顾问委员会
J委T	顾问委员会
售後服	售后服务
代理者	代理
聚合	集合
警	报警
警示	警报；警报
R	对齐；调准；对准
置中	居中
靠左R	左对齐
靠右R	右对齐
R文字	对齐文本
NR格	对齐到网格
所有n案	所有文件
所有型	所有类型
分配器	分配
字母	字母
文底	文字数字的
替代Y	代替信息
最上语@示	总在最前
歧x	歧义
美家W	美国国家标准化组织
美寿Y交Qa	美国信息交换标准码
比	模拟
源始，上代	祖先
Y^	锚点；锚接
o助^K	辅助区域
赢	动画
]解	注解
匿名	匿名
匿名登入	匿名登录
前提	先行
外^	外观
附加	追加
用程式	应用程序
用程式人化	应用程序个人化
用程式介面	应用编程接口/界面
弧	弧
架	机构
wn	归档文件
wn管理者	归档管理
引	自变量，变元
方向I；箭^I	方向键
Asianux 中日n作I平台	Asianux
Mg器	编译器
判定	主张
指派	指派
o助技g	辅助技术
非同步	异步
非同步交Q	异步交换
基元	原子
附加	附接
附加n案;An	附加文件
傩	属性
傩悦Q	属性名称
傩砸格	属性要求
傩灾	属性值
傩员砹行告	属性列表声明
音	音频
音描述	音频描述
音	音频轨迹
H呈F音	仅呈现音频
稽核	审核（计）
稽核防o	审核防护
X描述	听觉描述
JC；ae	鉴别
作者	作者
作	创作
C	权威；机构
授	授权；授权
自樱蛔拥	自动
自诱Z音辨R	自动语音识别
自愚D返	自动回滚
S	轴
後端	厚端
反向接	反向连接
骨	骨干
背景	背景
背景影像干_	背景图像冲突
背景程序	背景程序
退格字元	退格字符
回溯	回归
浞	备份
反向	向后
反向相容	向后兼容
LlD	条状图
laxC	条码阅读机
基A;基底	基础
基A本文	基础文本
基	基线
批次；整批	批
U率	波特率
袈	嘟嘟声
BSD 柏克Rwl行版	美国加州大学柏克利分校软件发行
Beta版	Beta版
二M位	二进制
二元\算子	二进制运算符
MY器	连接器
MY	连接
MY表_式	连接表达式
位元	位
色深位元	位深
c(D)	位图
位元遮罩	位掩码
位元速率;位元率	位速率
黑箱	黑盒
黑名	黑名单
^K；息K	块
方KD	方块
`	书签
_C；	启动
_C片	启动盘
虞d入物件	启动载入对象
_C;	自动；开机
注音符	注音符号
bot病毒	bot病毒
框	限界框
括	括号
盲人c字法	盲文点字
中	中断
中帱c	断点
蚪悠	桥
	简介
公事包	公文包
亮度	亮度
上移一	上移一层
提到最上	移到最上层
l	宽频
g[器	浏览器
BSD小耗	
BSDS可C	BSD许可
臭x	错误；臭虫
臭x追	错误跟踪
建立	建立
建立器	建立器
冉	内建
忙碌;忙碌中	忙碌
按o	按钮
位元M	字节
位元M序	字节序
C	机柜
快取	高速缓存
可快取	可快取的
小算P;算器	计算器
行事	日历
取消I	取消键
候x推]	候选推荐
能力；容量	能力；容量
祟}；字幕	标题
X取	抓取
卡	卡
CSSA邮颖	CSS串联样式表
大小相P	大小写相关
光碟C	CD刻录
光碟	光盘
光碟C	光驱
可x光碟C	可读写光驱
格；卧	格
水平置中	水平居中
垂直置中	垂直居中
中央理卧	中央处理器
C	认证
通道	通道
字元;字符	字符
字元Y料	字符数据
字元a	字符编码
字元模式	字符模式
字元⒖	字符参考
字元集	字符集
特殊字元	特殊字符
核取方K	选取框
x取擞	选取标记
子	子
子程序	子程序
流程O	
Chorous作I系y	Chorous操作系统
色度	色度
^K	块
e	类
e定x	类定义
e描述	类描述
e函式	类库
e名Q	类名
a品e 	产品类别
清除	清除
I袅	击键流
用;客舳	客户端
客簦伺服器	客户服务器(CS)
剪	剪切
剪N簿	剪切板
Y束;P]	关闭
P]所有Y料A	关闭所有文件夹
a；a	码；编码
a^段	代码段
合作	协作
折B	折叠
校ξ母	校对文本
集合	收集
色彩	颜色
色彩型式	颜色类型
行；直行	列
命令行	命令行
]解	注释
承Z	提交
共用l道介面	公共网管接口
壕o	压缩
相容性	相容性
相容	相容
g	编译
完成	完成
遵循	符合
m用	适合
g器	编译器
M件	组件
合成	合成
嚎s	压缩
X;算C	电脑；计算机
Xo助O	电脑基础设计
概念	概念
l件	条件
l件热	条件内容
l件^段	条件
C密性	机密性
MB	配置
MB器	配置编辑器
MB	配置
符合性	符合性
符合性l款	符合性条款
符合性e	符合性级别
符合性y	符合性测试
符合性文件	符合性文档
B接伺服器	连接到服务器
B接；BY	连接
一致	一致
主控台	控制台
常	常量
限制	限制
容器	容器
包含的文件	包含的文档
热蓍_l者	内容开发者
热菰件	内容元素
热莓a生	内容产生
热菽Ｐ	内容模型
热f商	内容协商
热萏峁┱	内容提供者
热葸x	内容选择
热菁	内容集
热莘元件	
热	内容
上下文	上下文
快@功能表	上下文选单
控制	控制
控制	控制项
控制台	控制面板
控制()工具列	控制工具条
便利	便利
DQ	转换
DQ工具	转换工具
}u	拷贝；复制
正_	正确
共同	
建立;新建	建立；新建
身份a	
PI^K	关于块
跨平台g器	跨平台编译器
跨平台	跨平台
目前的	当前
目前文件	当前文档
目前D示	当前图标
游	指针
自	自定义
客u化	定制
客u化	定制
剪下	剪切
Y料；	数据
Y料型	数据类型
Y料元件	数据元
Y料模型	数据模型
Y料碓	数据来源
Y料V要	数据纲要
Y料集	数据集
Y料Y	数据结构
Y料	数据库
Y料焖欧器	数据库服务器
Y料流	数据流
Y料型式	数据类型
Y料型式性|	数据类型属性
Y料值傩	数据值属性
日期crg	日期时间
死I	死键
死i	死锁
Debian 作I系y	Debian Linux操作系统
除e器	调试器
可判定的	
十M位	十进制
宣告	声明
宣告符	声明符
已宣告的	已声明的
分解	分解
解密	解密
推演	推论
AO	默认值
延t求C 	延时请求验证
定x必要傩	定义必要属性
定x傩灾敌褪	定义属性值类型
定x	定义
磁碟重M	磁盘整理[工具]
h除	删除；删除
鬟f的影像	传递图片
鬟f上下文	传递上下文
鬟f政策	传递政策
鬟f挝	转递单位
相依性	依赖性
不宜用	不建议
深度	深度
後代；子c	子孙；后代
桌面背景	桌面背景
桌上型X	桌面计算机
桌面窗	桌面窗口
目的地	目的
解	析构
Y	详细信息
b置	设备
b置oP	设备无关
b置oP	设备无关
D	图
υ	对话
υ框	对话框
滴	数字
滴嗬管理	
滴缓章	数字签名
S度	
б	指示
指]器，б器	
目	目录
目Ш	目录导航
失效；失能；停用	无效
反Mg	反编译
探索	探索
探索服 	探索服务
x散x	离散选择
x散目 	离散项目
磁碟	磁盘
磁碟C	磁盘驱动器
磁碟管理	磁盘管理
磁碟作I系y	磁盘操作系统
@示；@示器	显示器
分配；l行版	发行
文件	文档
文件字元集	文档字符集
文件w	文档实体
文件Z言	文档语言
文件模型	文档模型
文件物件模型	文档对象模型
文件序	文档顺序
文件O定n	文档轮廓
文件式诱Z意c格Z言	文档样式语义与规范语言
文件	文档树
文件型式	文档类型
文件型式宣告	文档类型声明
文件型式定x 	文档类型定义
文件化	文档化
W域	域
W域名Q伺服器	域名
W域名Q伺服器	域名服务器
每英键c	点每英寸
草稿(匣)	草稿
拖曳	拖放
下拉式x	下拉选单
p音多l	
Dublin Core 元Y料集	
}u；重}	复制
B热	动态内容
回	回应
	编辑
`	编辑书签
巨集	编辑Mcaro
子技g	电子书技术
子Y料交Q	电子数据交换
元件	元素
元件热	元素内通
元件名Q	元素名称
元件型	元素类型
元件型宣告	元素类型声明
子]件	电子邮件
嵌入式	嵌入式
嵌入式物件	嵌入式对象
嵌入式系y	嵌入式系统
嵌入式W路求	嵌入式WEB请求
b\算子	修饰运算符
空	空
空元件擞	空元素标记
⒂	使有效
封b	封装
加密	加密
Kc，末端，端c	终点
Y束	结束
Y束擞	结束标记
推	
入	进入
w	实体
w⒖	实体参考
登c，M口c，入口	入口
列e傩	列举属性
列e器	列举器
鼍	场景
等r	等价
e`	错误
跳；逸出	逃出
逸出序列	逃出顺序
事件	事件
事件	事件驱动
常；例外	例外；异常
可绦热	可执行内容
绦	执行
x_	退出
Y束a	退出码
U充名	扩展名
@式到期rg	显式到期时间
@性法t	显式规则
@式用粽求	显式用户请求
@式Web求	显式WEB请求
@式未定x行	显式未定义行为
R出	导出
表示式；表示	表达式
延伸式二Ma十M制交Qa	扩充二进制编码十进制交换码
延伸Y	扩充连接
延伸A定x元件	扩充预定义元素
U充性	扩充性
可延伸BYZ言	
可延伸耸菊Z言	XML
可延伸邮奖握Z言；XSLZ言	
延伸	扩充
外部的	外部
外部w	外部实体
外部擞宣告	外部标记声明
外部可_定 ID	
抽取；解嚎s	解压缩
分面	面
O施；O	工具
FAT-32n案配置系y	FAT32
乐劐e`	严重错误
常用n案	常用文件
最鄣	最喜欢的
特徵	特征
回	反馈
h笆	栅栏
表格直g式演算法	
谖唬	字段
n案；n	文件
n案g[器	文件浏览器
n案延伸	文件扩展
n案魉f定	文件传输协议
n名a生	文件名产生
^V器	过滤器
^V	过滤
ふ	查找
ふ蚁乱还P	查找下一个
防火	防火墙
gw	固件
先M先出	先进先出
首c定律	首节点规则
第一手	第一手
旗	旗；标记
快W	FLASH
磁碟片	软盘
磁碟片	软盘
碟C	软驱
Y料A	文件夹
後^元件	后续元素
字型	字体
_	脚标
前景	前景
表格;表	表格；表单
表格控制	表单控制
表格目	表单项目
格式化；格式	格式化
框架	框架
自由w基金	自由软件基金会
剩N空g	剩余空间
全幕	全屏
功能群M	功能组
功能y	功能测试
功能精`	功能精灵/向导
l道器	网关
通用w	通用实体
GPL 通用w授	GPL协议
同	通用
同僮Re符	通用标识符
GIF D形交Q格式	GIF图形格式
全域；全球	全球
字符	字符
	
GNU/Linux	GNU/Linux
前往	前往
D型的	图形
D形使用者介面	图形用户界面
D形	图形
D形b置介面	图形设备接口
灰A	灰阶
灰名	灰名单
牛桓褡	格子
群MRea	组ID号
旁]群集	
置	处理
硬碟	硬盘
硬w	硬件
C{m	
C{使用者w	
祟^n案	头文件
高度	高
f明;求助(息)	帮助
f明n案	帮助文件
AO到期rg	预定到期时间
[藏	隐藏
高	高级
高A	高阶
高亮度;反白;凸@(耸)	高亮
提示	提示
v史	历史
人Y料A;首	个人文件夹
家目；起始附	个人文件夹起始目录
首	首页
水平	
主C	主
主CZ言 	主语言
主C	主机
主W、主	主页
主C名	主机名
超文件耸菊Z言	HTML 超文本标记语言
超文件魉f定	HTTP 超文本传输协议
混合文件	混合文档
超接	超链接
超本文	超文本
D示	图标
等同	等同
已ReY料	已识别数据
Re符	标识符
表意文字	表义字符
^承	继承
影像	图片
影像Y料	图片数据
影像地D	图片地图
作	执行
作符合性明	执行符合性声明
作平_	执行平台
[性法t	隐性规范
[式W路求	隐性WEB请求
R入	导入
R入]包 	导入关闭
非使用中面	非活动页
流入	流入
收件匣;信箱	收件箱
包含n	包含文件
包含的	包含的
不一致的	不一致
s排	缩进
立w供商	独立软件供应商
立W	独立WEB
索引；指	索引
索引循序存取法	
索引色	索引色
索引的	索引的
g接包含	间接包含
w	独立
wr值性|	独立值属性
推理	推理
通知	通知
Y空g	信息空间
Y (理中)	信息
⒖急疚	参考文本
行	行内
入MB	输入配置
入目	输入项目
入(Y料)	输入(数据)
入(程序)	输入(程序)
查	查询
插入	插入
插入	插入列
插入n案	插入文件
插入列	插入行
安b	安装
例	实例
例Y料	实例数据
例Y料c	实例数据节点
e例	举例
整	整数
ew路	集成电路
完整性	完整性
智慧a	
增	增强
互;交互作用	交互
交式	交互式
互邮褂谜	交互式用户
介面	界面；接口
介面定xZ言 (IDL)	接口定义语言
中gn案	中间文件
炔康	内部的
炔w	内部实体
炔垮e`	内部错误
H式M	国际标准组织
H化Y源Re符	国际化资源标识符
WHW路	互联网
WHW路控制息f定	
W路	网路电话
WHW路f定	网络协议
W路聊天	网络聊天
WHW路服仗峁┱	网络服务提供商
交互\作性	可交互性
直g式Z言	解释语言
直g	解释
直g器Z境	解释程序环境
炔烤W路	局域网
固有S度	固有维度
o效	无效的
反函	反函数
不可	不可见
l出;h}	议题；
目	项目
JavaZ言	Java语言规范
JavaMC器	Java虚拟机
曲下d	
JPEGD形格式	JPEG图片格式
uU	
垃圾信(件)	垃圾邮件
核心	核心
金;I	钥匙；键
金MY	
I入	键入
金定位	键定位
金管理	钥匙管理
金名Q	键名
中止	中止
抽象e	抽象类
抽象宣告符	抽象声明符
摘要n案	抽象文件
存取遮罩	
ACE 存取控制 	
ぬ	帐户
累加器	累加器
@取	获得
活化子	激活
作用的；活拥	活动，现用
介面卡；{m器	适配器
加法\算子	加法运算符
定址模式	取址方式
取址\算子	取址运算符
相簿；］	
演算法	算法
e名	别名
混淆；X；取邮д	欠真
R	对齐
允S；容S	允许
歧x\算式	歧义表达式
分析器	分析器
角	角
答	应答
立即答	立即应答
答逾r	应答超时
消除X	消除锯齿；抗锯齿
反	反对数
套用	应用
弧度	弧度
n案位置	档案位置
嚎sn案；存n；wn	归档
算g移位	算术移位
排列	排列
列	数组
人工智慧	人工智能
演出者名Q	艺术家
f增	递增
外^	
M合Z言	汇编语言
Y合；P；f	关联；协会
Y合性	结合性
附件	附件
音光碟	音频光盘
音嚎s器	音频压缩
音串	音频流
AVI影音格式	视听交叉格式
o助n案	辅助文件
平均Y料流量	平均数据率
平均值	平均值
背r窗	
背景邮	背景样式
反向引用	反向引用
平衡	平衡
В活l	道带；频带；[地]带 
l	带宽
M幅	横幅
la	条码
密件副本	密件抄送
拍	节拍
行	行为
最好；最佳	最好；最佳
斜面；斜角	斜角
斜入	
斜出	
控制c	贝塞尔点
p立w	立方体
p向	双向
p性^V	双线性过滤
pZ	双语
二元搜	二分搜索
二元	二叉数
MY	邦定
MY热	邦定内容
位元谖	位字段
cD	位图
逐位元	按位
位元\算子	按位运算
混合映像	混合呈图
混合	混合
映像方向	呈图方向
K罘K	块符号
阻嗟M幅	阻止的横幅
阻嗟出式窗	阻止的弹出式窗口
阻嘧I	阻止操作
KD案	块
模糊	模糊
主文；本w	[主]体
影澹齑娲a	样板
布林	布尔
可_C光碟	可引导光盘
虞d入器	自展程序
框	边框
上框	上边框
下框	下边框
框色彩	边框颜色
框圈x	
框邮	边框样式
框度	边框框宽度
底界	底边界
界限	[受]束缚；界
界限	界限列
盒钍湛s	
盒罘派	
括ΨQ	括号匹配
有括的\算式	带括号的表达式
打散	打散
增亮	增亮
V播位址	广播地址
中嗟倪BY	中断的连接
蚪勇酚善	桥路由器
g[按oM	浏览按钮组
g[外^	浏览外观
g[字型	浏览字体
P刷	[画]笔
P刷^	笔头
f同控制	协同控制
n器；n；n^	缓冲；缓冲器；缓冲器[区]
n^欠d\行	缓冲区欠载运行
大量	整体；大量
大量}u程式	大量复制程序
大量Y料谖唤Q	大量记录字段交换
大量Y料列X取	多行存取
	刻(烧)录
O定值	刻(烧)录设置
程序	刻(烧)录程序
保C	刻(烧)校验
R流排	总线
I者	商业逻辑层
I瘴锛	商业物件
I樟鞒	商业流程
I找t	商业规则
按o暗影	按钮阴影
按o表面	按钮表面
按o反白	按钮反白
按o淡影	按钮淡影
略^清	
C 呼叫T例	C调用惯例
C BM	C联系规范
封包０腹c	
封包n案a生器	
校	校准
呼叫	调用；呼叫
呼叫	调用树
回呼	回调
回呼谖	回调字段
回呼函式	回调函数
呼叫T例	呼叫惯例
z影C	摄影机
取消	取消
候x函式	候选函数
候xI	候选键
效能z器	
插入	倒 v 号
回I	回车
CRLF 臀Q行M	回车换行
卡通	卡通
串；重B窗；重B@示	级联
案例	案例
卡	卡式磁带
D型	转换
分	分类
因果 ID	因果ID
副本	抄送
逆r	逆时针
CD 音特性；CD 音热	CD音频属性
}u光碟	复制光盘
置中R	居中对齐
R表沃醒	对齐表单中央
置中R	居中对齐
；接	链
更	变更；改变
CDF l道定x格式	频道定义格式
字元	字符
D表	图[表]
勾x；z查；核取	检查
入	签入
出	签出
和z查a	检验（查）和
晶片	芯片
凹刻	凹刻
凸刻	凸刻
x取	选择
套索	套索
^K包b函式	
A形收s	圆形收缩
A形放射	圆形放射
循h相依	循环依赖
循h⒖	循环引用
e衍化清	
eRe	类ID
清除	清除
初始B的X	裸机
按	点(单)击
素材n案	剪裁文件
裁剪路	剪裁路径
r	时钟
r	顺时针
仿u；仿u品	克隆
布	聚类；簇；群集[器]
解a器	代码转换器
制型D	类型强制转换
s回上	
理序；自臃猪	理序
定序；校	理序
合	组合
命令	命令
命令集	命令集
]解定界符	注释定界符
移除]	移除注释
委任	委任
通用控制	通用控制
通用Y料	公共数据记录
通用υ方K	通用对话框
COFF 通用物件n案格式	通用目标文件格式
比^元	比较
比^	比较
比ψ樱槐容^器	比较器
g器缺失蟾	编译器缺陷报告
gr期e`	编译期错误
互a；a色	补
完整物件	完整目标
CISC }s命令集X 	复杂指令集计算机
}s_本	复杂脚本
}sMY	复杂邦定
COM 元件物件模型	构件对象模型
撰	组成
}合文件	复合文档
Xo助翻g	计算机辅助翻译
串B索引I	拼接键
串B\算子	拼接操作
具w	具体
K行	并发性
同rB	并发连接
l件\算式	条件表达式
_J	确认
n突	冲突
B切	连接断开
使用中B	连接中
B中	连接中断
固定位元率	固定比特率
制等比例	约束比例
建式；建函式	构造
洽	接触
包含	包含
Ρ龋Ρ榷	反差，对比度
版	版权
	计数
封套	覆盖
爆音	
C	当机
_l小M	开发小组
PI^段；R界^段	临界区（段）
剪裁	剪除
交互	交叉编辑
交e淡	淡入淡出
十字游	十字指针
交叉Y料表查	交叉制表查询
跨程	跨线程
加密	密码术
提示表	插进指令表
	货币
曲	曲线
重覆循h	
循h冗Nz查	循环冗余校验
x表板	仪表盘
DAO Y料存取物件	数据访问对象
Y料中帱c	数据断点
Y料速率；Y料鬏率	数据率
Y料MY	数据邦定
Y料包	数据报
Y料包通端	数据报套接字
Y料工作表	数据工作表
分	分贝
o作用程式a	死[代]码
除e	调试，排错
解a器	译（解）码器
b名Q	装饰名
fp	减量；减去
深友}u	纵深副本
延t的	延期
形	变形
去交e	
延t游	等待指针
延t演算上色	
魉脱俞	延时传送
延td入	延时载入
委派	委派
全部h除	全部删除
h除行	删除行
h至行尾	删除至行尾
h至行首	删除至行首
定界符	定界符
三角方向	三角方向
部署	部署
解⒖	间接引用
子e；衍生e	导出类[别]
衍生型式	导出类型
fp；fp排序	降序
描述	描述
不x；取消x取	取消所选
原序列化	
O	设计
指定符	指定符
O者	设计者
O者主程式	设计者主程序
DTC Or期控制	设计期控制
Or期物件	设计期对象
H限Or期	设计期的
桌上型；桌面	桌面
N	销毁
拆x	分开
	细节
y	检测
_l者	开发者
_lh境	开发环境
程式_l伺服器	程序开发服务器
DCB 控制^KY料	设备控制块
b置映淌	设备驱动程序
\喾	诊断服务
芴	拨号
S需芴	按需拨号
υ方K列	对话框列
DDX υY料交Q	对话数据交换
DDV υY料C	对话数据校验
DLU υ方K挝	对话单元
芴W路配接卡	拨号网络适配器
芴W路B	拨号网络连接
芴伺服器	拨号服务器
差z器	差异查看器
U散	扩散
滴换日期	数字化日期
滴灰	数字视频
滴换	数字化
底	数字
合w字；有向D	有向图  
S；S度；尺度；尺寸	维；维度；尺度；尺寸
o效文字	灰暗(无效)文字
直接|B	直接电缆连接
直接B接	直接连接
方向	方向
目清畏K	目录清单对话框
反Mg器	反汇编
DAO 光碟一次 	光盘刻录一次
免明	免责声明
中	断开连接
嗬mD形	断续图形
磁碟嘶`	光盘卷标
分派	分派
分散式	弥散的
分配介面	分配界面
置	处理；处置
溶解	溶解
扭曲；失真	失真，畸变
分配；分散	分布；分配
l行版	发行版
分散式用程式	分布式应用程序
DCOM 分散式元件物件模型	分布式构件对象模型
DCE 分散式\算h境 	分布式计算环境
分散式管理h境	分布式管理环境
DTU 分散式交易f{器	分布式处理器
f色	发抖
分割邮	分割线样式
^K；部T	除
停v	入坞
文件鏖精`	文档传阅精灵
文件模板	文档模板
加亮	加亮
W域字尾	域名后缀
主控制	主控
Ac色彩	点颜色
句c\算子	点运算
c	点形状
Ac大小	点大小
c距；Acg距	点距
Ac量	点变量
快按纱	双击
杀洞笮	双倍大小
杀缎虚g距	两倍行距
DBCS p位元M字元集	双字节字符集
倍精度	双精度
p面水平列印	双面水平打印
p面垂直列印	双面垂直打印
向下I	向下键
按下B	按下状态
降	降低密级  
下d	下载
下降混合	下降混合
降低取	降低取样
下游	下游
不透明理	
	驱动
映淌	驱动器；驱动程序
DDK 映淌介_l套件 	驱动程序开发包
映淌酱牌	驱动器磁盘
磁碟C代	驱动器名
映淌侥＝M	驱动程序模块
滴落深度	滴落深度
下拉	下拉
水滴半	水滴半径
滴落影	滴落阴影
置放碓	置放来源
置放目	置放目标
下拉式M合方K	下拉式组合框
z漏框	遗漏框
滴管	滴管
p重介面	双重界面
pl道 (pZ)	双通道
O	哑，虚设
A印	转储  
出影	转储电影
持mrg；vr	持续时间
DVD 多功能滴坏片	DVD；数字[多功能]光盘
BMY	动态邦定
BY料交Q 	动态数据交换
B超文字擞Z言	动态超文本标记语言
BBY	动态连接
DLL BBY程式	动态连接库
易操作	易用
易移模式	易移除
易用更新	易更新
EA	椭圆
	边缘
可性	可编辑性
器	编辑器
撰L格	编辑风格
效果	效果
效果N	效果类型
有效位址	有效抵制
退出；出	弹出
^rg	经历时间
升降移	升降移动
升降感器	升降感应器
EA形工具	椭圆工具
省略	省略
{	强调
模M	仿真
封]；外ぃ桓郊	
a	编码
@型式	环绕类型
加密	加密
加密|l器	加密触发器
端；Y束	结束
Y束端c	结束端点
n案Y尾	文件结束
rgKc；Y束rg	结束时间
Y束	结束轨
K端使用者	最终用户
EULA 使用者授嗪霞s	最终用户许可协议
工程；工程	工程师
增型中^n案	增强型元文件
放大	放大
M入辛	排队
企I版	企业版
入口；；目；登	入口
列e	列举
列e性|	枚举属性
列e型式	枚举类型
分封；封套	包；封
h境	环境
Y尾a	结束码
等式\算子	等运算
等化器	等化器
等Y	等连接
抹除	擦除
橡皮擦工具	橡皮擦工具
e`绦	错误执行
e`z查	错误检查
e`更正；`差校正	纠错
e`理常式	错误处理器
e`息	错误信息
e`代	错误代码
逸出字元	转义字符
事件冒出	事件产生
事件理常式	事件处理器
事件介面	事件接口
事件收器	事件侦听器
事件日I	事件日志
事件τ	事件映射
事件遮罩	
事件物件	事件对象
事件程序	事件程序
事件登	事件登记
事件回物件	事件应答对象
事件方案	事件计划
事件_本程序	事件脚本程序
事件接收	事件接受
事件接收τ	事件接受映射
事件接收	事件接收
事件碓	事件来源
事件	事件驱动
事件理程序	事件处理程序
事件就w	事件就绪
事件接收	事件接受
跳式	每隔行
跳像素	每隔像素
辨R集	标志项集
例	举例
常宣告	异常声明
常理常式	异常处置器
常理展_	异常处理展开
常格	异常规则
排除	排除
互斥模式	互斥模式
绦凶衷集	执行字符集
豁免	免除
存在	存在
F有	存在
退出KD回	退出并返回
退出求助	退出帮助
展_；U展	扩大；展开
展_分支	展开分支
展_Y料A	展开文件夹
展_圈x	展开圈选
展_一	展开一层
U充w	扩充内存
＜夷Ｊ	专家模式
外@初始O定式	显式初始化
外@介面成T作	显示接口成员执行
外@BY	显示连接
外@⒖	显示参考
n案管	资源管理器
指	阶
公_	公开
\算式u估器	表达式求值
\算述式	表达式语句
延伸；U充	扩充
U充器；延伸器	扩充器
XSLT 可延伸邮奖碚Z言DQ	可扩展样式表语言转换
延伸w	扩展内存
滴管工具	滴管工具
淡	淡变
淡入	淡入
淡出	淡出
淡速度	淡变速度
失。皇效	失败
容e移D	失效后资源备份
快速}u	快速复制
正向快D	正向快转
快速播放	快速播放
反向快D	反向快转
快速呙	快速扫描
快速d入^域	快速载入区域
羽化	羽化
羽化填充	羽化填充
羽化x	羽化选择
特徵	特征树
提取	存入文件
诙界符	字段定界符
谖恍褪	字段类型
FAT n案分派表	文件分配表
n案P管理	文件关联管理
n案n^	文件缓冲区
n案X取	文件截取
n案	文件计数
n案描述	文件描述
n案例外	文件例外
n案置	文件处理
n案增量	文件增量
n案出入	文件输入/输出
n案L度	文件长度
n案表列	文件列表
n案i定	文件锁定
n案指	文件指针
n案性|	文件性质
n案	文件范围
n案B	文件状态
n案系y	文件系统
n案rg	文件时间
n案追器	文件跟踪器
n案	文件数
n案型式	文件类型
n案名Q	文件名
副n名	文件扩展名
n案伺服器用	文件服务器应用
填充	填充
填充色彩	填充颜色
填充因子	填充因素
填充段	填充段
填充式	填充样式
填充型式	填充类型
心三角形	实心三角形
片；影片	电影
影片片段	电影片断
V波器	过滤器，筛选程序
最K化	最终化
最K化光碟	最终化光盘
最K化磁碟	最终化磁盘
n案ふ	文件内查找
多重n案ふ	在多个文件内查找
０ふ	在项目内查找
ふ疑弦	查找上一个
ふ曳	查找符号
ふ夷	查找内容
ふ椅淖	查找文字
@；精	细致；精细
完成	完成
引l	激发
引l事件	激发事件
第一P	第一个记录
符合面	符合页面
修停还潭	修复；固定
定位	定位
固定υ方K	固定对话框
固定色P	固定调色板
固定我	固定单一
固定工具窗	固定工具窗口
定L字串	定长字符串
固定字幅	固定字幅
修	修复；固定
平	平
平面合成影像	平面合成图象
浮D示工具列	浮动工具条
平面化	平面化
平面化D	平面化层
避免重LW	
浮樱桓↑c	浮点数[类型]
浮	浮动
浮涌	浮动框
浮c	浮点
浮庸ぞ吡	浮动工具条
浮cY料型式	浮点类型
浮c函	浮点函数
浮c抵	浮点数值
浮c作I	浮点操作
流量控制	流控制
清除	齐平
焦c	焦点
焦c矩形	焦点矩形
定焦矩形	定焦矩形
Y料A追器	文件夹跟踪器
折B	折叠线
字型n	字型文件
字型τ称	字型映射
字型τ	字型映射
字型Y源	字型资源
字型方案	字型方案
字型z	字型视图
H限私用	仅限私用
制	强制
制框大小	强制帧大小
制每秒框	强制每秒帧数
前景色彩	前景颜色
前景色彩	前景颜色
前景窗	情景窗口
外用程式	外来应用程序
外碛跋	外来图像
外硭饕I	外健
外硭饕I表	外健表
表格e	表格类别
表格O者	表格设计者
表格器	表格编辑器
表格格O定	表格线设定
表格影像	表格图像
表格布局	表格布局
表格布局窗	表格布局窗口
表格型式	表格类型
表格z	表格视图
形式引	形式参数
形式当砹	形式参数列表
格式定xK	格式定义块
格式化磁碟	格式化磁盘
格式串	格式化字符串
格式邮奖	格式样式表
格式器	格式器
格式化中	格式化…
格式化矩形	格式化矩形
格式化工具列	格式化工具条
表格基A用	表格举出应用
表格哟	表格层次
正向，D送	转发
前置宣告	正向声明
向前一框	向前一帧
向前⒖	向前参考
已D信	已转发
H正向	仅向前
基Ae	基础类
四字元a	四字节码
框每秒	帧/秒
逐框播放	逐帧播放
框控制	帧控制
框抓取器	帧抓取
框	帧页
框速率	帧速率
逐框反D	逐帧反转
串流框大小	流帧大小
框窗	帧窗口
z漏框	帧遗漏
框每秒	帧/秒
框集	帧集；框架
框架	框架
步E框架	步骤框架
框e`	帧错误
可用位元M	可用位
可用D形介面Y源	可用图形界面资源
可用影像位元M	可用图像位
可用w	可用内存
可用面	可用页面
可用系yY源	可用系统资源
o限制程封送理器	
o限制程	无限线程
o限制程模型	无限线程模型
自由Q	自由变换
可用使用者Y源	可以用户资源
自由格式模型	自由格式模型
自由格式工具	自由格式工具
颖韭暑l率	样本率频率
常}集	常见问题[集]
H和名Q	
框	帧
框每秒	帧/秒
l信人；	从
前端	前端
完全控制M件	全部控件
完全 DV 品|	
完全BY	完整连接
全模Mz	
完整外部Y	完整外部连接
完整路矫Q	完整路径
全幕模式	全屏模式
全特化	全特化
完整面	完整帧
完全品|X取	
全幕	全屏
全形	全形
完整e名Q	完整类名
功能；函	功能；函数
函抵黧w	函数体
函岛艚	函数调用
函涤	函数计数
函岛w	函数覆盖
函敌告	函数声明
函刀x；功能定x	行数定义；功能定义
功能I	功能键
函当砹	函数列表
函滴锛	函数对象
函刀噍dQh程序	
函刀噍d	函数重载
函蹈	函数重写
函得枥L	函数描述
函倒	函数范围
函导	函数集
函的０澹还δ苣０	函数模板
函绦rg	函数执行时间
功能性	功能性
函舆BY	函数层连接
函惦r型	函数过程范围
基本型式	基本类型
未碇	
g隙索引	间隙索引
保C	保证
l	门
量L度	计量长度
高斯模糊	高斯模糊
GPF 一般性保oe`	
一般用途	通用
a生	生成器
a生器	生成器
同傺菟惴	通用算法
同兕eO定	类属类别设定
同俸铣e	类属合成别号
同俳立者	类属创建程序
型；L格	类型
取回^	获得区域
取回指	获得指针
n白	苍白
全域AO值	全局默认值
全域物件	全局对象
全域最佳化	全局最佳化
全域t	全局规则
全域_本	全局脚本
全域邮奖	全局样式表
全域	全局变量
光	光晕
字符快取	字形高速缓存
前往	转到
抓取	抓取
抓取控c	抓取句柄
抓取框	抓取视频帧
抓取框	抓取的帧
等名Q	等级名
灰A分	灰阶分类
灰Ax	灰阶选项
灰A邮	灰阶样式
w粒；粒罴y理	颗粒
粒子化VR	
	总计
D形	图形
D形物件	图形对象
D形重B	图形重叠
D形使用者介面	图像用户界面
D形外貌	图形外观
D形b置介面 	图形设备接口
D形⑹	图形说明
灰核χ	灰色检查值
灰x雾目	灰色选单项
灰A	灰阶
灰A色P	灰阶调色板
鸥窨刂	栅格控制
格布局	栅格布局
群M	组；成组
群M表列	组列表
群M成T	组成员
群M重新命名	组重命名
群M方K控制	控件组
保C	保证
程式a保o^g	代码保护区域
保o^段	保护段落
指ЬV要	指南
指	导则
指引	指南
客	黑客；黑客
硬w失能	硬件禁用
一半大小	一般大小
半形	半形
置器	处理器，处理例程
置i定n突	处理锁定冲突
交握	联络
凸排	悬挂式缩进
硬限制器	硬限制器
硬D回	硬回车
硬a	硬码
硬碟	硬盘
硬碟C	硬盘驱动器
硬w加速	硬件加速
硬w填色	硬件填充颜色
硬w透通	硬件透明
粗	粗湿
s演算法	哈希算法
s多重集	哈希多重集
s	哈希数
s表	哈希表
s值	散列值
型	
祟^；x^；^端	磁头；头[部]
祟^；表^	首部
祟^控制	标题控制
祟}	标题
堆e	堆；堆
堆e配置	堆分配
烈模糊	强烈模糊
A高度	内圆高度
求助热	帮助内容
求助映射n	帮助映射文件
求助概^	帮助概要
求助０n	帮助项目文件
求助搜こ淌	帮助查找程序
求助x	帮助选择
求助主}	帮助主题
|的	异类的
十六M位A印	十六进制转储
十六M位	十六元，十六进制
[藏	隐藏
[藏文字	隐藏文字
[藏下落式影	隐藏下阴影
A	层次[结构]
高位元	高位
高A	高阶
醒目文字	高亮文本
醒目	高亮
醒目的n案型式	高亮文件类型
高A字	高阶字
嘶等	嘶声等级
降低嘶	嘶声降低
c簦幻中	查到；暂扰
c粲担幻中	点击计数
cy；命中y	点击测试
cya	点击测试代码
按住	按下
托架；持有者	持有者
全像	全息图
家庭	家庭视频
r截	钩连点
r截函	
r截程序	
水平百~窗	水平百叶窗
水平	水平线
水平解析度	水平分辨率
水平暂S	水平滚动条
水平g距	水平间距
水平K排	水平排列
水平停v	水平停住
主用	主应用程序
bd控制	主控
bd能力	主控能力
bdY	主控信息
主C名Q	主机名
徕o	热钮
徭I	热键
暗粉t	按粉红
狳c	热点
沙漏游	沙漏指针
html 布局n案	html布局文件
html清理	html清理
集器	毂；集线器
色{	色调
人可x的	人可读的
超BY位址	超链接地址
超BY基底	超链接基础地址
超文字BY	超链接文本
超文字擞Z言	超文本置标语言
超文字⒖	超文本参考
超文字鬏通f定	超文本传输协议
D示列	图标栏
D示n案	图标文件
D示Y源	图标资源
整合_lh境	集成开发环境
Re符前Y	标识符前缀
Re符文字	标识符文本
Re；身分	识别
Re增量	识别增量
Re分割	识别分割
ReN子	识别种子
f置	空闲
f置感器	空闲传感器
f置B	空闲状态
f置rg	空闲时间
忽略	忽略
忽略大小	忽略大小写
非法的	非法
影像基底	
影像n案	图像文件
影像D	图像库
影像表列	图像列表
影像器	图像记录
影像序列	图像序列
影像大小	图像大小
影像	图像编辑
直接引	直接变量
直接基A	直接基础
直接衍生	直接衍生
直接呈F	直接呈现
直接⑹	直接叙述
直接窗	直接窗口
作	执行
作介面	执行界面
依作定x	执行定义
作者	执行者
入[的；[含的	隐含
[含BY	隐含连接
[含⒖	隐含参考
R入Y料炷０	引入数据库模板
R入n案	引入文件
R入函	引入函数
M行中	进行中
不作用	非活动
英	英寸
包含	包含
人	引入
f增\算子	递增运算符
f增浞	增量备份
f增建置	递增构建
f增BY	递增连接
f增BY器	递增连接器
f增搜	递增搜索
f增Bn案	递增状态文件
s排空格	缩进空格
立wS商	独立软件供应商
索引循序存取法	索引顺序存取法
索引z	索引视图
索引子	索引子
索引子骰匦褪	索引子回传类型
指示	显示
指示器；指示符	指示器，指标
指示器限	
g接\算元	间接内存运算
g接法	间接法
人模板	个人模板
推理t	推理规则
o限大	无限大
o限f	无限递归
字g法；中置法	中缀记法
商IYV告	
Y	信息；信息；信息；信息
Y热	信息内容
Y流	信息流
Y模型	信息模型
^承循h	继承循环
^承A	继承层次
初始容量	初始容量
初始化n案	初始化文件
初始化	初始化
初始器	 初始化表达式
初始化髡	初始化传真
墨水瓶	墨水瓶
套	嵌套
行冉M合器	行内组合器
行冉M合程式a	行内组合码
行日归_	行内展开
行n案	行内档案
行群	行内函数
行饶_本	行内脚本
行仁	行内式样
刃苯	内斜角
炔款e	内部类别
炔坷外	内部例外
炔柯合	内并[符]
炔筷影	内阴影
炔度	内宽度
就地	就地启动
就地⒂	就地启用
地按o	就地按钮
理中	处理中
理中M件	处理中组件
理中慑e	处理中调试
理中伺服器	处理中服务器
入	输入
入焦c	输入焦点
入位	输入位准
入法器	输入法编辑器
入碓	输入来源
插入色彩	插入颜色
插入	插入颜色
插入底	插入数字
插入查	插入查询
插入Y果	插入结果
插入值查	插入值查询
插入	插入列
填M	填充列
可插入物件	可插入对象
嵌入浮凸	嵌入浮雕
插入路	嵌入路径
炔砍绦	内部程序
	内实线
z	检查
例置	实例处理
例方法	实例方法
例	实例变量
例模型	实例模型
例F隹刂	
例影	实例模版
例化	例示
子C工程W	电气和电子工程师协会
指令排程	指令安排
整敌褪	整型
整w服滴痪W路	综合服务数字网
(色彩)和度；度	饱和度
度立wa	
r截器	拦截器
互B方案	互联方案
介面定xZ言	接口定义语言
介面n案	接口文件
介面Re符	接口ID
介面Re符	接口标识符
介面型式	接口类型
整合	集成
ew路	集成电路
染吧彩	
交e	隔行
交e效用	交错效用
交e	交错
中g目	中间目录
中g事件	中间事件
中介Z言	媒介(中间)语言
炔挎Y	内连接
炔客顿Y蟪曷	
HO定	国际设定
WHW路控制息通f定	互联网络控制报文协议
WHW路工程任招〗M	互联网络工程任务小组
WHW路封包	互联网络包
WHW路伺服器用程式l展介面	互联网络服务器应用编程接口
WHW路伺服器U充	互联网络服务器扩充
WHW路伺服器^V器	互联网络服务器过滤器
WHW路服展商	因特网服务提供方
炔	内插
解g器	解释器
中啵徊	中断
交集	交
g隔	间隔
冉ǔ	固有常数
冉控制	固有控件
冉ê	固有函数
o效字元	无效字符
o效n名	无效文件名
o效分e`	无效分页错误
不因e而	不因国别而异
不量\算式	不变表达式
不因Z言而	不因语言而异
大小互Q	大小写互换
倒深度	颠倒深度
反相x取	反相选取
挑取；{用	启用
IP 位址	因特网协议（IP）地址
IP 	因特网协议（IP）编号
ISAPI U充精`	ISAPI扩充精灵
ISAPI ^V器	ISAPI过滤器
隔xΥ^	隔离存储区
隔x等	隔离等级
h}表	问题详细表
l出者；l卡挝	发行者
h}表列	问题列表
目目	项目目录
目延伸	项目扩展
目n案名Q	项目文件名
目路	项目路径
目	项；项
迭代	迭代
迭代	迭代
迭代器	迭代
不t列	不规则数组
堵塞圈	堵塞循环
微	微动
Y；合	并，联结
Yl件	连接条件
Y	联结线
Y\算子	连接运算符
合立w	联合立体声
uU	操纵杆
光碟；c唱C	换碟机
跳越，跳位	跳[转]  ；跳[转]
跳越⑹鍪	
跳到	跳转到
YY料表	连接资料表
R；{整	整版；调整
JustLink技g	JustLink刻录技术
保留外^	保留外观
保留出	保留签出
B排	紧排
I框	键框
金	密钥对
金O定	密钥设定
金C	密钥验证
PI值；I值	健值
IPZ言及布局	键盘语言及布局
IP布局	键盘布局
IP布局n案	键盘布局文件
褪色效用	退色效用
底宙IP；小IP	小键盘
PI字器	关键字编辑器
PI字文字	关键字文字
美工刀	刀；美工刀
知R	知识库
知R煳恼	知识库文章
知R工作者	知识工作者
颂；嘶`	标号；标号
有舜诺	有标磁盘
有⑹	有标叙述
X科W室	计算机科学实验室
λ表式	λ表达式
LAMP W站平台	LAMP网络平台技术(Linux + Appache + MySQL + PHP/Perl)
M式	横[长]式
Z言MY	语言邦定
Z言元件	语言元素
Z言Φ	语言对等
Z言Re符	语言标识符
Z言中性	
大D示	大图标
大型ew路	大规模集成电路
雷射	激光
雷射唱片；雷射唱P；影碟片	激光碟片
套索工具	套锁工具
最後	最后
最後修改	最后修改
最後位置	最后位置
延後MY	
延後正化	
l	启活
	层；层
分右窗功能	分层窗口功能
布局	布局；布局；布局
布局n案	布局文件
w布局	内存布局
插槽布局	插槽布局
前位元M	前导位
入；引入	导入
入	导入轨
С觯灰出	导出
С鲕	导出轨
行距；前	行距
前Я	前导零
~c	叶
W版	学习版
租用	租用
最低有效位元M	最低有效位
靠左R	左对齐
左箭^	左箭头
左I按二下	左键双击
靠左校正	
左I	左键
左限	左边界
滑鼠左I	鼠标左键
左外部Y	左连接
合法的	合法的
合法著作	合法著作权
法律明	合法声明
合法商	合法商标
L度	长[度]
字母；信	字母
等；蛹；哟危晃剩活e；；樱晃浑A	级[别]；层
Z》治銎	词汇分析器
Z」	词汇范围
Z】臻g	词汇空间
程式旃芾碚	库管理员
程式	[文件]库
程式n案	库文件
程式彀姹	库版本
授	许可
授嗪霞s	许可证协定
授嗵理器	授权处理器
授喾桨	授权方案
生命期	寿命
p微模糊化	轻微模糊
亮度	亮度
p量	轻量
p量控制	轻量控制
p量型h端程序呼叫	
限制	限制
；M列；行	线路；行
嘈	断行
行	行计数
行涵w	行覆盖
下移一行	下移一行
行尾Y束	行尾
行	行号；线路[编]号
行剖L	
行	行范围
行分隔符	换行符
行K端符；K止器	行终端
直工具	直线工具
NR	
性化表格	
行Bm字元	
跳行	隔行
跳行字元	隔行字符
行模式	行模式
行模式g[器	行模式浏览器
BYD表	链接图表
BYn案	链接文件
BY格式	链接格式
BY物件	链接对象
BY碓	链接来源
BY文字	链接文字
BYrg	链接时间；链接时间
BY精`	链接精灵
BY/x入/x出	链接/读入/读出
Y格	链接要求
BY基A	基础链接
BY目	链接项目
接串列	链接[列]表    
BY物件	链接对象
BY式庸ぷ鞅	链接样式工作表
BY表管理者	链接表管理器
BY窗框架	链接窗口框架
BY窗	链接窗口
BY器	链接器
BYc嵌入	链接与嵌入
BY元件	链接元素
BY程式	链接库
BY	链接
BY列	链接条
托瓦 (Linux核心的l明人)	Linus Benedict Torvalds(Linux内核创始人)
Linux 作I系y	Linux  操作系统
Linux_l平台格	Linux开发平台规范
Linux核心	Linux内核
Linux 驶A	Linux标准基础
列出f助主}	列出帮助主题
串列理Z言	
列表z控制	列表视图控件
列表方K控制	列表框控件
收	收听
收模式	收听模式
收者	收听者
收者用	收听者应用
收者服	收听者服务
字面文字	文字
字面文字常	文字常数
字面文字w值	
d入；荷	装入；
d入行	载入行为
d入有效位址指令	载入有效位指令
d因	负载因素
d入D示	载入图标
需要d入	按需载入
rd入	启动时载入
d入{色P	载入调色板
d入D片	载入图片
d入rg	载入时间
已d入	已载入
d入B	载入状态
^域；本地；本C	局部，本地
^域W路	局域网
本地e；^域e	本地类别
本地副本目	本地拷贝目录
本Cn案	本地文件
本地^域W路	
本C	本机
本地模式；本C模式	本地模式
本地名Q	本地命名
^域物件	本地对象
本C部件；本地部件	本地部件
本地路	本地路径
本CB接埠	本机端口
本地０	本地项目
本地h端程序呼叫	本地远端程序呼叫
本地Y源	本地资源
^域	本地范围
本地伺服器	本地服务器
^域担槐镜刈	局部变量
本地W站用	本地WEB应用
本地W站伺服器	本地WEB服务器
本地h境	本地环境
本地h境Re符	本地环境标识符
本地h境特定	
可本地化	本地化
本地化	局部化
本地化	本地化
本地化n案	本地化文件
本C的快取副本	
^域	
位置方K	
位置中帱c	
位置Y	
i定控制	锁定控件
i定	锁定计数
i定位置	锁定位置
i定０	锁定项目
i定Yn案	锁定信息文件
i定模式	锁定模式
i定`	锁定违规
i定型式	锁定形式
日I；存；	[记]日志；[记]日志；日志
日In案	日志文件
日Iz器	日志查看器
	对数
日In案	日志文件
	逻辑
e`	逻辑差错
P刷	逻辑笔刷
色板	逻辑色板
B接	逻辑连接
座讼到y	逻辑坐标系统
和	逻辑和
等r	逻辑等价
字型	逻辑字体
[含	逻辑隐含
行	逻辑行
\算子	逻辑运算符
移位	逻辑移位
卧	逻辑单元
z；^c	逻辑视图
登入	注册
登出	注销
L日期格式	长日期格式
Ln名	长文件名
L整	长整数
L指	厂指针
查找	查找
查找表	查找表
圈；路	循环
圈造	循环构造
圈外提	
路干_	循环干扰
圈最佳化	循环最佳化
循h	循环
散耦合	松耦合
_	松开
漏失	损失
重要漏失	重要损失
o漏失嚎s	无损压缩
漏失嚎s	有损压缩
低序位	低序位
低功率消耗	低功耗
低A	低阶
下限	下阶
照度	
C器a	机器码
Y料碓疵Q	数据来源名称
C器可理解的	机器可理解的
巨集	宏[定义]
巨集定x	
巨集展_	宏扩充
巨集g[器	
巨集表列	
巨像素	
巨集υ	
魔g棒工具	魔棒工具
放大	放大
]件伺服器	邮件服务器
]件系y	邮件系统
信箱	邮箱
]寄名	邮递清单
主用窗	主应用窗口
主控制器	主控制器
主框架窗	主窗口
主w	主存储器
主x	抓选单
主息圈	主消息循环
主路由	主路由
主表	主表
主表x取υ方K	主表选取对话框
主绦芯w	主线程
大型X	主机，特大型机
So用公用程式	维护程序
主要版本a	主要版本号码
u作增益功能	制作插件
u作副本/浞	制作备份
０妇`	项目精灵
手皂	手册页
可管理的服	可管理的服务
管理	管理
管理能力	管理能力
管理界面	管理界面
管理政策	管理政策
管理Z意	管理语义
管理者	管理器，管理程序
Z	
手裕皇	手册
手咏MBO定	手动配置
手舆BY	手动链接
u造者；u造商	制造商
多Χ嚓PS	多对多联系
τ常D；映射	映射；映射；映像
τn案	映射文件
τ尘W路	映射网络
τ尘W路磁碟C	映射网络驱动器
τ尘W路Y源	映射网络资源
τ常挥成	映射
Cx目	机读目录记录
限	版口，页边空白
限指示符	
擞	加标[记]
苏I	标记符；标记符
耸拘告	标记声明
耸菊Z言	置标语言；置标语言
耸灸Ｐ	置标模型
跑R艨刂	跑马灯控件
M理	
遮罩	屏蔽；掩码
遮罩cD	屏蔽位图
遮罩	屏蔽层
遮罩^	屏蔽区
被遮罩控制	屏蔽编辑控件
大量Υ嫜b置	大量存储设备
光碟母片	光盘母片
匹配；符合	比对
成括	成对括号
大小符合	匹配大小写
前Y符合	前缀匹配
子字串符合	子字符串匹配
H限全字拼符合	仅限全字匹配
色版	调色板
最大混合	最大混合
最大化按o	最大化按钮
最大化窗	最大化窗口
最大	最大
最大每秒位元M	最大位数每秒
最大鬏卧	最大传输单元
最大e`量	最大错误数
多媒w控制介面	多媒体控件界面
多重文件介面 	多文档界面
被y量事件	被测事件
y量挝	测量单位
C制	机制
媒w布局	媒体布局
媒w；媒介；中等的	媒体,介质；媒体；媒体；中[间]
中度模糊化	中度模糊
成T	成员；成员
成T存取\算子	成员存取操作
成T函	成员函数
成T初始化表列	成员初始化列表
成T名Q	成员名称
成Tx	成员选项
成T型式	成员形式
成T	成员变量
成T存取控制	成员存取控制
成TY格l件	成员资格条件
成T逐一	成员逐一
成T逐一}u	成员逐一复制
渫	备忘录
w配置	内存分配
w^K	内存块
w快取基底物件	内存高速缓存基础物体
布局	内存布局
漏失	内存泄露
模型	存储器模型
物件	
使用差	内存使用差异
x	选单
x	启动选单
x瓮庥^	选单外观
x瘟	选单条
x慰刂	选单控件
x雾目	选单项
x翁a	选单编号
x纬淌郊	选单编程
x钨Y源	选单资源
x慰sD	选单缩图
x雾目Re符	选单项目识别符
合	归（合）并
息	消息，报文；消息，报文；消息，报文；消息，报文
息方K	消息框
息中帱c	消息断点
息相P	消息相关
息交Q型	消息交换样式
息n案	消息文件
息^V器	消息过滤器
息置器	消息处理器
息置器	消息处理
息祟^	消息头
息圈	消息循环
息τ	消息映射
息封b	消息封装
息推	
息辛	消息队列
息接收者	消息接收者
息反射	消息反射
息可靠度	消息可靠性
息l送者	消息发送者
息槽	消息汇（宿）
息鬏	消息传输
息	消息驱动
息置函	消息处理函数
息τ稠	消息映射入口
息τ尘藜	消息映射巨集
用程式_l饔介面	信息应用编程接口
元嘶`	元标签
元字元	元字符
元热	元内容
後OY料	元数据
後On；元n案	元文件
量表控制	仪表控件
方法	方法
度量	度量
微X	微电脑
小~付款	小额付款
每框毫秒	毫秒每桢
滑鼠中I	鼠标中键
中	中层
中A	中阶
D移精`	转移精灵
小型A印	小型转储
最少重建	最小重建
米	厘米
次要版本a	次版本号码
分	分钟
R像	镜像
R像@示字型	镜像显示字体
R像表列	镜像列表
R射W站	镜像站点
s	杂项
不匹配；不符合	不匹配
z失	丢失
混合热	混合内容
混合式	混合式启动
混合模式光碟	混合模式光盘
助符	
模B	模态
模B	模态
模型	模型
模型MY表示式	模型邦定表达式
模型目	模型项目
模型目性|	模型项目属性
模型理	模型理论
o模式	非模态
o模式形式	非模块形式
塑模	建模；建模，造型
塑模Z言	建模语言
塑模工具	建模工具
C	调制解调器
CB接	调制解调器连接
修符	修饰符
修符I	修饰符键
修改	修改
模M化	模块化
模M化模型	模块化模型
模M	模块；模块
模M定xn案	模块定义文件
模M哟	模块层次
我	单音
握Z言	单语言
等字型	等（间）距字型
握{	单调
月芽刂	月历控件
最末衍生e	
最高有效位元M	
主}Y源管理者	主题资源管理器
主}窗管理者	主题窗口管理器
移影粹o	移动按钮
移又敢	移动指南
移舆x	移动选单
幼餮ag	
燧d	装定夹；装[上]
滑鼠捕捉	鼠标捕捉
滑鼠事件	鼠标事件
滑鼠息	鼠标消息
滑鼠指烁嬷	鼠标指针通知
滑鼠目	鼠标目标
移n案	移动文件
移淤Y料A	移动文件夹
工具下移	工具下移
工具上移	工具上移
影Re符嘶`	电影识别标签
MPEG 音	MPEG音频层
分秒框位置	分秒桢位置
多重	多重会话
多位元M字元集	多位字符集
多位元Ma	多位编码页
多播	组（多）播
多aR入/R出	多码引入引出
多S	多维
多Z文	多语言
多行控制	多行编辑控件
多Z文	多语言
多重BYY	多链路连接
多重τ	多重映射
多媒w控制	多媒体控制
多重	多重
多重文件介面	多文档界面
多重文件型式	多文档类型
多重n案	多文件
多重x	多选
多行控制	多行编辑控件
多重x癖砹蟹K	多选列表框
多工	[多路]复用
多工器	复用器
乘法	乘法
乘法\算子	乘法运算符
多f定鬏W路	多协议传输网络
多用途WHW路]件延伸	多用途的网际邮件扩充协议
多重集合	多重集合
多重绦芯w	多线程
多重绦芯w^K模型	
多重绦芯w用	多线程应用[程序]
多使用者	多用户
多使用者h境	多用户环境
多重z	多重视图
多卷嚎s	多卷压缩
音菲段	音乐片段
音芬	音乐视频
o音	静音
互斥物件	互斥物体
互斥	互斥
名Q	名称
名Q修	名称修饰
名Q空g	名称空间
具名引	命名变量
具名`	命名书签
具名e	命名类别
具名	命名参数
具名S可集合	命名许可集合
具名管道	命名管道
具名序列	命名序列
名Q空g污染	名称空间污染
名Q空g前Y	名称空间前缀
名Q空g有效	名称空间有效
名Q空gC	名称空间验证
名Q空g合格	名称空间合格
命名s	命名规定
命名方案	命名方案
家Z言支援	国家语言支持
原生；固有	本原
原生音	本原音频
原生a	本原[代]码
原生g器	本原编译器
原生Y料	本原数据
原生e`	本原错误
自然Z言	自然语言
本|	自然
в[列影像	导航列图象
в[	导航
向後в[	向后导航
向前в[	向前导航
в[	导航；导航；导航
в[列	导航条
в[C制	导航机制
в[Y	导航结构
近指	近指针
f商热	协商内容
f商後OY料	
巢套	嵌套
W	网
W路新	网络新闻传输协议
W路新魉f定	网络新闻传输协议
W路配接器	网络适配器
W址Dg	网络地址转译
W路位元M次序	网络字节序
W路卡	网卡
W路B接	网络连接
W路n案系y	网络文件系统
W路Y服	网络信息服务
W路d平衡	网络负载平衡
W路服仗峁┱	网络服务提供者
W路M件	网络组件
中性	中性
Q行字元	换行字符
c	结点；结点；结点
正常	正常
正常按o	正常按钮
正常拖曳	正常拖拽
正常绦	正常执行
正常起始	正常初始化
正常x	正常选择
正常大小	正常大小
正常窗	正常窗口
的文字	规范文字
法	记法
法宣告	记法声明
淇迹辉]解	注解
P型X；P本	笔记本电脑；笔记本
通知息	通知信息
通知服	通知服务
通知	通知
p推；微{	[逐像素]挪动
微增度	稍微增加宽度
向上微{	稍微上调
空；空值	空值
空⑹	空语句
o助位元	辅助位数
每像素位元	每像素位数
每颖疚辉	每样本位数
拷	拷贝数
框	帧数
每^K框	每块帧数
平面	平面数
串流	流数
初始框	初始帧数
抵	数值
抵当硎臼	数值表达式
底宙I台	数字小键盘
抵	数值参数
抵敌褪	数[字]类型
物件	客体；对象；客体
基於物件	基于对象
物件g[器	对象浏览器
物件g[器^V器	对象浏览器过滤器
目的a	目标[程序]码；目标[程序]码
物件描述Z言n案	对象描述语言文件
物件表示式	对象表达式
目的n案	目标文件
物件A	对象层次
物件程式	对象库
物件BYc嵌入	OLE
物件τ	对象映射
物件模型	对象模型；对象模型；对象模型
物件模M	目标模块
物件模M格式	对象模型格式
物件向	对象向导
物件集^	
物件性|	对象性质
物件限定符	
物件B	对象状态
物件型式	对象类型
物件	对象变量
物件z器	对象视图
物件向O	面向对象的设计
x	义务
八M位	八元；八进制
x作I	离线操作
xl行	离线发布
x}u	离线复制
上	在线
\作中	操作中处理
步{一致	
一Χ嚓PS	一对多联系
一σ魂PS	一对一联系
描D	
幕IP	屏上键盘
物件向程式O	面向对象编程
不透明度	不透明度
_放式Y料爝B接	ODBC；公共数据库接口
_嘞	开启独占权限
_放Y模型	开放信息模型
_放服占	开放服务架构
_放wf明	开放软件说明
_放w基金	开发软件基金会
_放音系y	开放声音系统
_放源a	开放源码
_放系y互B	开放系统互连
_^嘶`	开口标签
\算元	操作数
操作a	操作码
作Ih境	操作环境
作I；操作；\算	操作
作I失	操作失败
作I系y；操作系y	操作系统
\算子；\算符	运算符
\算子居先	运算符前置
_放式	开放式
_放式K行	开放式并行
_放式i定	开放式锁定
最佳化	最佳化
最佳化中^Z言	最佳化中继语言
最佳化提示	最佳化提示
x裥裕贿x	选项
x裥砸	选项参数
x裥孕	选项行为
x裥蕴蒯	选项特征
次序；排序；命令；A	次序;排序
有序	有序
序	序数
循序索引值	序数索引值
序堤a	序数号码
定向；指向	指向
原者	原创者
原始伺服器	原始服务器
原始Kc	原始终点
原始路	原始路径
原始O定	原始设定
原始位置	原始位置
原始起c	原始起点
示波器	示波器
l信匣	发件箱
w不足	内存不足
出；流出	输出
外斜角	外斜角
外部合	外部连接
外部型式	外部类型
外部度	外部宽度
外部高亮度	外部高亮度
外部影	外部阴影
在外邮	外部样式
出；外送信件	输出
出介面	输出界面
大V；外框；廓	大纲
H出	仅输出
出	输出
出A	输出阶层
出模B	输出模态
出	输出参数
出精识	输出单精度
出串流	输出流
出窗	输出窗口
外部程序	外部程序
外部^域	外部区域
超量	超量刻录
超量光碟	超量刻录光盘
超量	超量写录
溢位	溢出
突出部分	
~外	
重B音	重叠音频
重B窗	重叠窗口
覆w	覆盖[程序段]；覆盖表格
覆w影像	覆盖图片
覆w模式	覆盖模式
覆w字幕	覆盖字幕
超d；^d	超载；过载
超d解析	过载解析
重d函	重载函数
重d\算子	重载运算符
重d集合	重载集合
超d；^d	超载；过载
置Q；改	重写
超量	超量刻录
覆；重打	复写
概^	概况
覆	复写
所僖窗	所属窗口
碛姓撸恢骺卣	拥有者
主控窗	主控窗口
主控描L控制	
主控描L按o	
所有啵碛	所有权
包b；嚎s	包装
套b；套件；封b	包；打包
封b暨部署精`	打包与部署精灵/向导
封b函	封装函数
封b精`	打包向导
封b IP 位址	封装IP地址
封包	打包
封包整合	打包整合
WHW路封包探索	PING
封包交Q	打包交换
封包入	打包写入
填a；填塞	填充
填a^K	填充区域
填a粒度	填充粒度
P]填a	关闭填充
_⑻钛a	开启填充
分	分页
WO者	页设计者
分e`差	页错误差异
分n案位元M	页文件位组
置入面	置入页面
面布局	页面布局
移出面	移出页面
面O定	页面设置
面DQ	页面转换
面[	页面视图
分捍^	
分器；呼叫器	
油漆桶工具	油漆桶工具
{色板；色P	调色板
色Pτ	调色板映射
色PO定	调色板设定
香港版	
窗格	窗格
面板布局	面板布局
面板M合	面板设置
全景z影	
A	
段落格式	段落格式
段落分隔符	段落分隔符
平行；K列	平行
店列	参数数组
	参数
^K	参数块
蒂Y料成T	参数数据成员
w	参数实体
鬟f	参数传递
登爸	参数前缀
翟O定	参数设定
滇嶂	参数后缀
w⒄	参数实体参考
敌兔令	参数型命令
//H；父；上	父
上宇e	父类
上幽夸	上级目录
上游募型式	上级文件类型
上颖	上级表单
上禹目	上级项目
上舆x	上级选单
上游锛	上级对象
上禹面	上级页面
上映绦	上级程序
上颖	上级表
上右窗	父窗口
H子PS	父子关系
同位旗	奇偶标志
剖析τ	解析影射
已剖析字元Y料	已解析字符数据
已剖析w	以解析实体
剖析器	解析器
先行剖析e`	先行解析错误
剖析	解析
零件；部分	部分
部分相等	部分相等
局部特殊化	局部特殊化
部分理解	局部理解
⑴c	参与
粒子大小	粒子大小
粒子	粒子
分^；分割	分区
按址鬟f	地址传递
按⒖鬟f	参考传递
按值鬟f	值传递
通P密Z	
被	被动
被幽Ｊ	被动模式
鬟f查	传递查询
密aCf定	密码验证协议
密a表列	密码列表
N上成	粘贴为
修a；修a程式	补丁
路	路径
路嚼弧	路径括弧
P刷感工具	
路缴疃	路径深度
路矫Q	路径名
型樱D	样式
型悠ヅ	样式匹配
型幼执	样式字符串
和	暂停
d安全性	负载安全性
Ma	虚拟码
峰	峰
峰值分n案位元M	峰值分页文件位
峰值M位元M	峰值虚拟位
峰值工作集	峰值工作集
Φx表板	对等仪表板
ccW路	对等网络
P	笔
UP	铅笔
R置	搁置
R置目	搁置项目
半影	半影
可感知卧	可感知单元
百分比位置	百分比位置
履行；绦校施	执行
效能	性能
效能O器	性能监视器
期g；L期	期间
L	周边
LM件B接	周边组建互连
Lb置	周边设备
永久；常v	永久
永久Υ嫫	固存
S可；嘞	许可
S可防o	许可防护
型式Z意	
S可	许可
保存	保存
持m	持续
永mΥ嫫	固存
人	个人
人JC	个人认证
人Y料理器	个人数据处理器
人滴恢理	个人数码助手(PDA)
人n案	个人文件
性	个性
透扭曲	
封]式	封闭式
封]式i定	封闭式锁定
A段；相位	阶段
拼音建h	拼音建议
假性目	假性目标
相片	相片
w位址	物理地址
wP刷	物理笔刷
wb置	物理设备
w字型	物理字型
ww	物理内存
D片	图片
D片方K	图片框
D片渲染	图片渲染
管；Ч	管
管	管线
g距；定音	间距
屑~z	
像素	像素
像素重覆	
孜环；A留位置	预留位
A留位置形	预留位置形状
文字；本文；明文	纯文本
平台	平台
W路热莺Yx平台	互联网络内容选择平台
播放	播放
播放	回放
倒放	倒放
S插即用	即插即用
外	插件
口袋	口袋书
c	点
注c；c	关注点
指	指针
指瞬糠	指针部分
指怂俣	指针速度
Y料指	数据指针
Y料成T指	数据成言指针
成T指	成员指针
成T函抵	成员函数指针
指塑E	指针轨迹
指诵褪	指针类型
ccf定	点对点协议
政策	政策
政策防o	政策防护
多形模式	多边形模式
多形工具	多边形工具
多形填M模式	多边形填充模式
多型	多型
捍^的	
出式x危豢祜@x	弹出式选单
出式窗；快@窗	弹出式窗口
埠	端口
埠名Q	端口名
埠a	端口号
可y式	便携式
可y式W路D形	PNG
可y式作I系y介面X	便携式操作系统见面X
部份	部分
直式；肖像式	
位置	位置
N	张贴；投递
後文；跋	后文
後建置	
後置法	
後置g隙	
事後剖析慑e	
延後	
力	潜力
功率校正	功率校正
s能源	节约能源
能模式	节能模式
源方案	电源方案
源供	电源供应
MA使用者	
	实践
先行版	先行版
前文；序	序
前置放大	
前置n器	前置缓冲器
前建置	
前置元件	
精_游	精确游标
精_度	精确度
先行g	先行编译
先行g祟^指示	
A先M成字元	
A先定x	预定义
述~	断言
Ay	预测
A先加	
偏好b置	
偏好	
前置；前Y	前缀
前置法	前缀符号
前置g隙	
A先BY	预连接
Ad	预载
前置主控	
前置理	预处理
前置理器	预处理器
先Ql件	
保留	保留
AO	预设
按；海怀霭嫔	按
良好[私系y	
A[	预览
首要	
首要c型式	
列印跨	打印跨页
列印管理者	打印管理器
列印s放	打印缩放
列印多工n器介面	
列印^	打印区
列印成品	打印
先啵先等	优先权
[私；私密	隐私
私密{C	
私密政策	
私密金	私钥
Ｓ梅獍	
私用	私有变量
特	特权
有特嗟淖髡热	
可享特嗟rg	
程序	过程
程序Re	过程ID
^m；_展	继续
^程；理；理程序	处理
理指令	处理指令
a品；乘e	产品
a品金	产品Key
生a	生产
a能M件	产能组件
a能工具	产能工具
剖L；O定n	
剖L器	
剖L	
可程式化	可编程的
程式ORe	程序ID
程式O	程序员
程式O	编程
M度列	进度条
uM式	渐进式
uM式x	渐进式选项
０溉照I	项目日志
投影C	放映机
提示；提示入	提示
提示字串	提示字符串
C明	证明
所有嘧C明	所有权证明
性|定x	属性定义
已提案推]	
提案推]	
命}	
保o	保护
f定	协议
原型	原形
分度器	
C明	证明
提供者	提供者
供商代理	代理商
供w	供应实体
近似位置	近似位置
代理；代理伺服器	代理
代理伺服器	代理服务器
Ma	虚拟码
M行	虚拟列
MM理	
MSC	
M目	虚拟目标
公用；公_	公开
公用Y料A	公用文件夹
公_Re符	公开识别符
公_金	公钥
公_金密aW	公钥密码学
公_金基A建O	
公用物件	公用物体
上公共	公共在线论坛
公用程序	公用程序
公用使用者	公共用户
出版品；l行物	出版物
l表；l布	发布
l表人；l布者；出版商	发布者
}n；}波；鼙P式	脉冲
打孔	打孔
它c符	标点符号
目的；意D	目的
限定；合格	合格
合格名Q	合格名称
限定符	限定符
限定；合格	合格
品|	质量
品|保Cy套件	质量保证测试套件
品|保C	质量保证测试套件
服掌焚|	服务质量
辛	排队
查	查询
辛髡	排队传真
辛忻Q	排队名称
快速_	快速启动
快速u	快速记录
快速z	快速审查
快速绦	快速执行
快速抹除	快速擦除
配~	配额
引用；引言	引言
引	引号
引Re符	引号识别符
引瓤闪杏	
加上引	加上引号
引蛹	引号级别
放射畈季	放射状布局
o；o	无线
芜x按o	单选按钮
芜x按o	单选按钮
半	半径
基	基数
凸起浮雕	突起浮雕
SC	随机
SC存取w	随机存取内存
SC水平l	随机水平条
SC垂直l	随机垂直条
SC溶解	随机溶解
y	随机数
SC化	随机化
SC表列	随机列表
y诞a生器	随机数产生器
值	范围值
A；等	排位；等级
快速用程式_l 	快速应用开发
光	光栅
光棚@示器	光栅显示器
c字型	光栅字型
光胚\算	光栅运算
鸥窕	光栅格
c化文字	
比率；速率	比率
分	分级
分；~定值	分级
原始的；未理的	原始的
原始Y料	原始数据
原始介面指	
x取；x	读
A先x取n^	预读取缓冲区
x者；x取器	读者
x我n案	说明
就w；渫	就绪
真模式	真实模式
即r	即时视频
接收	接收
接收者；接收器	接受者
辨R；Re	认可
推]；建h；推]	推荐
重新B	重新连接
{解	调解
；u	记录
按o	记录按钮
分隔符	记录分隔符
谖唤Q	记录字段交换
z	记录审查
u旁白	录制旁白
器	录音机
恢	恢复
矩形工具	矩形工具
矩形列	矩形数组
矩形座	矩形坐标
f	递归
重新芴	
重新向	重定向
重新向方案	重定向方案
重新向_本	重定向脚本
重L	重绘
sp；s小	减少
精指令集X	精简指令集电脑
⒖迹⒄	参考
⒖纪暾性	参考完整性
反射	反射
重整速率	刷新速率
^域	区域
捍嫫鳎辉]	寄存器
捍嫫Υ骖e	寄存器存储类别
捍嫫髯	寄存器变量
捍嫫饕窗	寄存器窗口
]再Y料	注册资料库
]阅_本	注册脚本
]用程式	注册应用程序
]裕坏怯	注册
]再Y料	注册数据库
t事件	规则事件
正表示式	正则表达式
正表示式物件	正则表达式对象
具w化	
相P章	相关章节
PS	关系
P式Y料	关系数据库
P式\算子	关系运算符
相BY	相对连接
相β	相对路径
相Υ^	相对区域
相rg	相对时间
放；l行	释放
l行版	发行版
可靠度；可靠性	可靠性
剩N	剩余
剩Nrg	剩余时间
湓]	备注
h端存取服	远程存取服务
h端X	远程电脑
h端B	远程连接
h端Y料控制	远程数据控制
h端Y料物件	远程数据对象
h端Y料服	远程数据服务
h端慑eO器	远程调试监视器
h端慑e	远程调试
h端磁碟	远程磁盘
h端C器	远程机器
h端管理	远程管理
h端程序呼叫	远程程序呼叫
h端Y源	远程资源
h端感y	远程侦测
h端伺服器	远程服务器
重新命名n案	重命名文件
重新排序	重新排序
修	修复
重}	重复
重}次	重复次数
全部取代	全部替换
重新绦校恢匦虏シ	重新播放
}u	复制
}u管理器	复制管理器
回覆	回复
回覆位址	回复地址
蟾	报告
蟊砑合	报表集合
Υ	仓库
Υ煲擎	仓库引擎
表示	表示
求	请求
求u	请求评论
重新取	重新取样
U止推]	废除推荐
保留	保留
保留^	保留区域
保留大小	保留大小
重置；重O	重置
解析度；Qh	决议
Qh\算子	决议运算符
Y源	资源
Y源g[器窗	资源浏览器窗口
Y源描述框架	资源描述框架
Y源器	资源编辑器
Y源n案	资源文件
Y源Re符	资源标识符
Y源目	资源项目
Y源型式	资源类型
Y源z	资源察看
Y源定xn案	资源定义文件
回	回应
重新	重新启动
限制；s束	限制
Y果集	结果集
Y果_J	结果确认
重	重试
回魑恢	返回地址
回鞔a	返回码
回骰l	返回收到
回餍褪	返回类型
回髦	返回值
反向文件次序	反向文件顺序
反向f增搜	反向递增搜索
反向呙	反向扫描
慢速反向播放	反向慢速
原成	还原成
修正；修	修订
修控制系y	修订控制系统
撤N	撤销
В坏罐D	倒转
靠右R	右对齐
右界	右边界
滑鼠右I	鼠标右键
LU管理	风险管理
C械的	机械的
	卷动
根	根
旋D	旋转
路由	路由
路由O定	路由设定
例行工作；常式	例行工作
路由；x路	路由
列	行
列指	行指针
列蛹安全性	
列集合	
橡皮D章工具	橡皮图章工具
橡皮筋	橡皮筋
t	规则
尺	尺
\行rg	运行时间
\行r	运行时
\行rg	运行时
\行rg型式Y	运行时间类型信息
H限\行rg	仅限运行时
右值	右值
安全的	安全
安全^域	安全区域
颖荆还例；取	样本
取由疃	取样深度
颖旧疃瓤s放	取样深度缩放
颖敬笮	取样大小
取	取样
取宇l率	取样频率
健全y	健全测试
M足	符合
和	饱和
Υn案	保存文件
n案另存	文件另存为
Υ０	保存项目
０噶泶	项目另存为
Υ娣桨	保存方案
方案另存	方案保存为
x取^另存	选取区域另存为
可s放性	可缩放
可s放向量D	可缩放矢量图
量字型	
量型式	
硕龋豢潭龋豢s放	刻度
s放傩	缩放属性
呙	扫描
呙璐a	扫描码
呙杈	扫描线
呙槠	扫描仪
情景；情	情景
鼍	场景
鼍y	场景侦测
鼍八饕x	场景索引选单
鼍斑x取器	场景选取器
排程	日程
概要；V目；Y描述	结构描述
Y描述O工具	结构描述设计
Y描述	结构描述编号
Y描述列集	
Y描述Z	
方案	方案
科W@^	科学园区
	范围
宣告	声明范围
\算子	范围运算符
窗格	范围窗格
解析	范围解析
方案	范围方案
捍娲诺	暂存磁盘
幕座	屏幕坐标
幕放大R	屏幕放大镜
幕x器	屏幕阅读器
hT	记录员
_本物件模型	脚本对象模型
_本作者	脚本作者
	滚动
臃K	滚动快
暂S	滚动条
密封	密封
o接pY	无线连接
Seamless Link技g	Seamless Link刻录技g
搜l件	搜索条件
搜t	搜索准则
搜ご涡	搜索次序
搜そY果	搜索结果
搜つ	搜索目标
正割	切割
秒；次等；第二	秒；第二
次	次级
次要相依Y	次要依赖信息
次要介面	次要界面
次要Z言	次要语言
^段；；段	节
磁^	区域
保全；安全	安全
安全警告	安全警告
安全O定	安全设定
安全性；保全	安全性
安全O督	安全监督
安全架	安全架构
安全傩	安全属性
安全核	安全审核
安全描述符	安全描述符
安全I域	安全领域
安全Re符	安全标识符
安全C制	安全机制
安全模型	安全模型
安全物件模型	安全对象模型
安全嘞弈Ｐ	安全权限模型
安全政策	安全政策
安全政策表_	安全政策表达
安全服	安全服务
安全支援提供者介面	安全支持提供者接口
安全精`	安全精灵
安全地^	安全地区
亦⒄	亦参见
N子	种子
段；^段	
^段方案	
反相x取	反向选择
x取行	选取行
可x取的	可选取的
自我解嚎s	自解压的
自我Y	在连接
自我⒖	自我参考
Z意需求；y嘌	语义需求
Z意W	语义WEB
Z意透明	语义透明
Z意	语义
旗	旗号
非完全信任	非完全信任
l送	发送
重新l送	重新发送
魉偷	发送到
移到最下	移到下层
送至g[器	发送至浏览器
可l送	可发送
l送者	发送者
敏感度	敏感性
感y器	传感器
分隔符；分隔器	分隔符
分隔	分隔线
分隔符字元	分隔字符
分隔字元	分隔字符
音序器	音序器
序列	序列
循序	有序的
循序容器	有序容器
循序Ш	有序导航
循序u估\算子	有序评估运算符
序列；串列	序列
序列存取	序列存取
序列介面	序列界面
串列路WHW路f定	
序	序号
序列埠	串口
序列鬏	串行传输层
序列化	序列化
系列	系列
系列形B	系列形态
	
伺服器用程式	服务器应用程序
伺服器文件	服务器文档
伺服器管	服务器管理器
伺服器U充功能	服务器扩充
伺服器端元件	服务器段组件
服	服务
服战M件	服务组件
服彰枋	服务描述
服战槊	服务接口
服罩薪	服务中介
服仗峁┱	服务提供者
服照求者	服务请求者
服战巧	服务角色
服照Z意	服务语义
服仗峁┱	服务提供者
服向架	服务导向架构
^段；	会话
^段一次 (SAO)	
^段Rea	会话ID
^段名Q	会话名称
^段物件	会话对象
O定；集；集合	置位；设置
O定	设定为
O成AO值	设为默认值
O定自虞d入	设定自动载入
O定列擞	设定列标记
O定光碟跳S	设定光盘跳
O定字型	设定字体
集合函	集合函数
O定BY	设定连接
O定x伟粹oBY	设定选单按钮连接
O定x芜BY	设定选单连接
O定印表C字型	设定打印机字体
O定返回到x	设定返回到选单
O定sD	设定缩图
O定控制台	设定控制台
源方案O定	设定电源方案
O定值	设定值
O定完成	安装/设制完成
影	阴影
影模糊	阴影模糊
表友}u	阴影复制
形	形状
形罘诸	形状分类
形钐崾	形状提示